111111111111
100000000001
100000100001
100000003001
100000400001
100020000001
100000000001
100000000001
110000000101
100000000001
100000000001
111111111111
