111111111111
100000000001
100000000001
130003000001
100000004001
100000003001
101000002001
100000000001
140000013001
100001000041
140030004001
111111111111
