111111111111
100000000001
100000000101
100001000001
100000040301
100004000001
100000010001
100000000001
100100300001
100001000201
100000000001
111111111111
