111111111111
100000000001
100000100011
100000000001
100000400001
100040000001
100003000001
100000003001
100002100001
100010000001
100000000001
111111111111
