111111111111
100000400001
100000000001
100000400001
100301000001
104000004001
103000030001
100003001001
100000000001
100002000001
100030000401
111111111111
