111111111111
100000000001
100000000101
100030100001
100000000001
100400000001
100000000021
140000000301
100000000101
100000000001
110000000001
111111111111
