111111111111
100000100001
100000000001
103000000001
100300000001
140000400001
100001000001
100000001001
100000000001
100010002101
100000000101
111111111111
