111111111111
100010000001
110000000001
100011000001
100000100001
100020000001
100400000001
100000030001
100000000001
100000000001
100000000001
111111111111
