111111111111
100000000001
100000000001
100000000001
100000001001
100000100301
100040000001
100002430001
100000000001
100000010001
100010000001
111111111111
