111111111111
100000010011
100000000001
100000100001
100000000001
101001020101
104000100001
100130000001
100000000001
100000100001
100000000101
111111111111
