111111111111
100000000001
100000000001
100000001001
110000030001
100000001001
100000402001
100000000001
101000000101
101000100001
100001000001
111111111111
