111111111111
100000000001
100001000001
100000001001
100000103001
100000000101
100004000001
100000010001
100002000001
100000000001
100010010001
111111111111
