111111111111
100040000001
101000100001
100000103001
101000001001
101043020001
100030000001
100140000001
100000300041
100000000001
100100000001
111111111111
