111111111111
100000000001
100000000001
100000000001
100040000001
100000300201
100040000001
100000003001
100030000001
100000000401
100000000001
111111111111
