111111111111
100000000001
100000000001
100030110001
100400110001
100000001001
100004000001
140030030001
100002000101
100000100001
100010000001
111111111111
