111111111111
100000000001
100000110001
100400000001
101000000001
100013004001
100000000001
103010000001
100002000001
100000000001
100011000011
111111111111
