111111111111
100000000001
100000000001
100000000101
110000000001
100000200011
103010410001
100100000001
100000000001
100000000001
100000000001
111111111111
