111111111111
100100000001
100000000001
100000010001
100000210001
100004010001
100010000001
100100013001
100000000001
100000000001
100000000001
111111111111
