111111111111
100000000001
100000000001
100100000001
100004000101
100000000001
100030000201
100000000001
100100000001
100000000001
100000000101
111111111111
