111111111111
100000000001
100000400101
100200400001
103000000011
103000000001
100400000001
100000030001
101000000001
100000000001
100001000001
111111111111
