111111111111
100010000001
100000100001
100000101001
100000000001
100000000001
100000000001
100003040001
100000020001
100000001001
100000000001
111111111111
