111111111111
100000000011
100000004001
114000000001
100010000001
100000030001
100000000401
100001000101
100100300301
101000020301
100000040001
111111111111
