111111111111
100000000001
100000100001
101000000001
100000041001
100003001001
100000300001
100000000001
100000400001
100200000001
100000100001
111111111111
