111111111111
100001000001
100000000001
100000040201
100000004301
101000000001
104001000001
100000330001
100000000001
141400303001
100110000001
111111111111
