111111111111
100000000011
100010000001
100000000141
100000000001
100000000001
100000040001
100100001001
100003030001
100000200001
100001000001
111111111111
