111111111111
100000000001
100000401001
100030000001
100400000001
100000011001
100103000001
100300040001
101000000001
100000020001
100000000001
111111111111
