111111111111
100000000001
100000400001
100000000001
100001030001
100201000001
100000400001
100000004001
101000101311
100003000001
100040000301
111111111111
