111111111111
100110000001
100000000001
104001030001
140000004001
100004003011
100000000001
103010000001
100000000011
100032000001
100010000001
111111111111
