111111111111
100000000001
100000000001
100001100001
101000003001
100000000001
100004000001
100000100001
100000100001
100000200011
100001000001
111111111111
