111111111111
100000000001
100000000101
100000010001
100003041001
100000000001
100000100001
100000000041
110000000001
100003000001
100002000001
111111111111
