111111111111
101000001001
100000010001
103000000001
100010000001
100000000001
100000003301
100040000001
100000000021
100000400001
100040030141
111111111111
