111111111111
100010000001
100000010001
100000000001
100003000001
100400100001
100030000001
100410000001
100001000001
100002000001
100000000001
111111111111
