111111111111
100100000001
100000000001
100000000001
100000004001
100040300011
103100400001
100000000341
100303000001
100010040001
100001021001
111111111111
