111111111111
100000000101
100000000001
100003000001
100003000401
100000000001
100000000001
100000000001
100000000001
100001100041
100000200001
111111111111
