111111111111
100000000101
100000000001
100300030401
100004100001
100000000041
100000030001
100000000011
100010040001
100030020001
100001000001
111111111111
