111111111111
100000000001
100000400101
100034000001
100400000001
100000003001
100000100001
103000000001
100020000001
100000000101
100001000001
111111111111
