111111111111
100000000001
100000001001
101000000001
100002010001
100100000101
103000000001
100400000101
110000000001
100000000001
100000000101
111111111111
