111111111111
100000000001
100000000001
100000000001
101030001001
100000101001
100000402001
100000000001
100000100001
100000000001
100010000001
111111111111
