111111111111
100000000001
100000000101
100000400001
100000100001
100100110001
103100000001
100004200001
100000100001
100010030001
100000000001
111111111111
