111111111111
100000000011
100000000041
100000000201
100030000001
100001000001
100001000001
100000010001
100000010001
100000000001
100000000001
111111111111
