111111111111
100000000001
110100110101
120001110101
100401000001
110100000011
100110111311
100004111001
100110430001
100000031001
100000000001
111111111111
