111111111111
100000100001
100011100011
100030000001
101010200401
100010111111
101013100001
101410104301
100000110011
100010010001
100000000011
111111111111
