111111111111
111011100111
100000000001
111011131001
100040000001
100101110101
113101011201
110100000041
100000011001
111001011101
111100000001
111111111111
