111111111111
100003000401
100000110101
100101100101
100101100401
110100020001
100001103001
100100301111
110011100001
100011400001
100000011111
111111111111
