111111111111
111011111101
100000400001
110013211301
100000003001
111010101001
111001111401
110001100401
111001100101
111001000001
110000000001
111111111111
