111111111111
140003010001
104000010101
101010000301
104001110101
111000000011
100001101011
111000120001
110010110001
110000300001
100011111001
111111111111
