111111111111
100000000001
100003430001
100004141001
101010101301
100000100031
100000100141
101000010201
101100303101
100000004401
110001010001
111111111111
