111111111111
140000001001
140000100001
100113000001
100000011001
100001110001
100100100001
110011012101
100000000001
110003000001
100000000101
111111111111
