111111111111
100000000001
111000034001
110140101001
100001001001
100100100001
110011003001
101000001001
101100101001
100001102001
100011100001
111111111111
