111111111111
110000140001
110030400001
100000000001
100140113101
111000030001
100000000001
100010000001
103400010201
100000010101
110000010001
111111111111
