111111111111
100340100001
100000000001
100111003001
110000110401
100010110001
110100000001
100001001041
100001101001
100003023431
111000004001
111111111111
