111111111111
141011011111
100000000011
100011110001
101010110001
100000113021
101010300011
101000010011
100000410001
101100110001
100000000011
111111111111
