111111111111
101000000001
102031011101
100000400101
101004000001
101301010001
101401010011
100011010001
111100030301
100000000001
110000014001
111111111111
