111111111111
100000000001
110000140001
110000030001
100010000201
100000101001
101101003401
100110330401
100000003411
100000300401
100041110101
111111111111
