111111111111
101100010111
101100100001
104001000001
100001000101
100000110001
111000000111
101014001101
103010000001
100000000301
111002100101
111111111111
