111111111111
101100010011
100000000001
103001000001
101010001001
100040021001
101110103001
100010010001
100004300001
100000000001
101104000011
111111111111
