111111111111
104100010111
100010010001
100010010011
110000000101
100230041101
100001111001
100000000101
100103010001
100004000301
100110000101
111111111111
