111111111111
100011000001
100000000001
110400100011
100000001011
100001310001
101101000101
100000140001
100111003011
100000000011
120001000001
111111111111
