111111111111
100000001001
100100000001
101100010001
100000000101
100101000201
100100101001
110003000001
110310000101
100000440001
110001000001
111111111111
