111111111111
100001000001
100000100001
100100130001
110000400041
100101042101
104041030001
100300000001
101430131001
103000004301
100000000001
111111111111
