111111111111
110000000001
100100111011
110001111011
111011400011
100000001001
110101001101
100001101101
110100020001
110131100001
110001110101
111111111111
