111111111111
110000000001
110100010101
100100030101
100301110101
100000000101
101001110001
101100400101
100002401001
100010100011
101110100001
111111111111
