111111111111
110000000011
110101110101
140001100001
100100011011
100101301011
100001200011
100101001011
110101011001
110000000001
110000000001
111111111111
