111111111111
101110000011
100030011001
100000000001
100121100101
110100114101
110000110001
100110010001
100000000011
101000010011
111011011111
111111111111
