111111111111
100000000001
100000004001
102010000001
100001031101
101100100001
100110011101
100000000101
100110000001
100000001001
100000000001
111111111111
