111111111111
110000000001
100100103001
110100101001
100110140001
110000001101
100110000001
100110111201
100030000001
100000000001
141111000111
111111111111
