111111111111
100001011001
100000000001
110131100001
110102000001
100110100101
100110101101
100110101001
100000000001
101011101001
100000000041
111111111111
