111111111111
100000100011
100000001001
100010100001
100120301001
110110101101
110000110101
100110010001
100000000101
100000100101
100040111101
111111111111
