111111111111
110000000001
100011011001
101011011001
101000030011
100101011011
111020010041
100110110101
100110000001
100001000101
100000000101
111111111111
