111111111111
100000000001
100000301001
100111100041
100101120001
100000000101
101011100101
100000000101
100010000001
100100100101
100001100001
111111111111
