111111111111
100000010001
100104000001
100140000101
100100103301
100100100001
103000003301
100004410301
100102000001
100040100001
100000000041
111111111111
