111111111111
100001000001
100000404001
100300010011
100000002001
100000111001
110140003301
100010104001
100011000001
100300000001
100000000001
111111111111
