111111111111
100100000001
110001100001
100040010001
100140100011
104100000201
100030300101
100030000001
100000330001
100001000001
100040010401
111111111111
