111111111111
100100000001
100000000001
100001040001
101003000001
100042103001
100004101001
100130400001
100000000011
100111030001
100000000001
111111111111
