111111111111
100000000011
100110000101
100010000001
110003300001
100000102001
101030004101
101004400001
100000010101
100111003041
100000010001
111111111111
