111111111111
140000010401
100003000011
101100001001
103011010301
100000001001
103011441001
101001130041
100000400021
103410000301
100010000001
111111111111
