111111111111
100100000001
100001030001
100000011001
100043400001
110010030041
100013400301
100004040001
100010000021
100000030001
100000000001
111111111111
