111111111111
100000100101
100010404001
110001300001
100030000201
100001100001
101000001001
100110111001
101100400001
100034003001
101000000001
111111111111
