111111111111
100000000001
100000001001
100001000001
100001430001
101111001141
100010000001
100000110001
100011000021
100000301101
100000100001
111111111111
