111111111111
100000100001
100000000001
100011400001
101000000101
100440430301
103030430001
100100031201
100000300001
101000400001
100000400001
111111111111
