111111111111
100000000001
100100010001
100001040001
101411000001
100000303111
100001403001
100030030001
100001020101
100004010001
100010400001
111111111111
