111111111111
100003410041
100000000011
100001310011
100001000001
100040400001
141330100001
101000000301
100000000021
103040100001
100000010001
111111111111
