111111111111
100000000001
101001031001
100000000001
100400100001
101400111001
100140001001
100032010011
100013010001
100000010001
100000000001
111111111111
