111111111111
101000000011
101000010001
100030000101
101014010301
100010440301
101000031001
100400140001
100001000101
103100020001
100000010001
111111111111
