111111111111
111011011101
104011010001
140000000001
100110020001
100001040301
140000000301
113100011001
100100000301
100100400301
100000000001
111111111111
