111111111111
140410000001
100000101001
101000301001
100031301001
101100000141
100100300101
100044000001
100030100001
100010001321
100004000001
111111111111
