111111111111
100110011001
100000100001
101000001001
110411131201
114000000001
101003001011
100000030301
101104100401
100010000101
100000000011
111111111111
