111111111111
100011000041
100100001001
100001030301
100011010001
100100100101
100000100341
100100404201
103001010001
101001000001
100000001001
111111111111
