111111111111
140000000001
100000100001
100000140011
100300110301
103002103101
110000400001
100001000001
100004013001
100141000001
100000000001
111111111111
