111111111111
100000000001
100000000001
100010000001
103402401001
100000433041
100110000001
100100000101
100000100101
101100300001
100000000001
111111111111
