111111111111
100000000001
100000000001
100010010001
100004010001
103304040201
100031040301
100000100001
100101000001
100001001001
100001000001
111111111111
