111111111111
140300001111
100100140001
100010000041
111000000031
104000301001
100330040011
100100001201
100000100001
101100010001
100000000001
111111111111
