111111111111
100000010011
101000011001
100000000001
100000001001
104101100011
101101040011
100130030001
100002011001
100000034111
100000000001
111111111111
