111111111111
110400000001
100034000001
110100000001
103000010101
101000110001
100030400111
101021000001
100110000101
100300040001
100010100001
111111111111
