111111111111
100000001001
100001000001
100030030001
100110104001
100043400001
100040010001
100030400001
110100302001
100001000001
100000000001
111111111111
