111111111111
104000300011
100010000001
100001000011
101103014011
100400240011
100100330041
104001100001
100030000011
100003000111
100000000001
111111111111
