111111111111
100100110401
100000000001
100013003001
100140000001
100000011301
100110011001
100140021101
100000400001
100311000001
100000000011
111111111111
