111111111111
104000000001
100000000001
101000000101
100001100001
101001402311
100010031001
100001001001
100010001001
100000000001
100000000011
111111111111
