111111111111
100000100111
100000030001
100130010001
104000000401
100403141001
100102030001
100043001101
100101003001
110111004001
100000000001
111111111111
