111111111111
100000000001
100010110001
100100000001
101103040101
100103314001
104000300211
101000011401
100010000001
101000011001
100001000001
111111111111
