111111111111
100000000001
100010001001
100003111001
101104200001
100000300001
140001110301
104030400001
101000040001
100030100001
100000100001
111111111111
