111111111111
100001000001
110000003011
100000001011
100001110001
111104000101
103040000041
100101300001
100000020001
100000010001
100011000001
111111111111
