111111111111
100000000401
101000000001
120400310001
100000000001
100000000001
100030030101
101000000001
100000010001
100010100001
104000000001
111111111111
