111111111111
100000000011
100000000011
110002001001
100000010001
100000400011
100011131101
100000000101
100011000001
100000000111
101100100001
111111111111
