111111111111
140100000001
100000000001
100000000001
101000400011
120003300001
100000000011
110010000001
100000000001
100000000001
110001000001
111111111111
