111111111111
100000010001
100000000011
100000000001
110020000001
100000010001
101004000011
101013101001
100010000001
100100000001
100000110001
111111111111
