111111111111
100000000401
100400000401
100000000001
101300000001
100000303001
110400302001
100000000001
100000000001
100000000001
100010000001
111111111111
