111111111111
100000001001
104000000001
101000000001
100000031011
110004200001
100000000011
140103300001
100001000001
100000000001
100000000001
111111111111
