111111111111
100000000001
100000000001
140002400001
103000000011
114000000001
100000000001
100030303101
100010000001
110000000001
140000000001
111111111111
