111111111111
101000000001
100000000001
100000000001
110004000001
100000001001
110020011001
100000300001
100110001001
100000001001
101000010001
111111111111
