111111111111
100000000041
100130200001
100300010001
141004000001
100000000041
100001000101
100000000341
110000003001
110000300001
100000004301
111111111111
