111111111111
104400000001
100000000101
103000000001
100000020001
100030330001
100000000001
104000000001
100001000001
100100001401
100000001001
111111111111
