111111111111
100000000001
100000001101
100000400001
100001000001
100000100101
100000003001
103000000401
102000000001
100000000001
100000100101
111111111111
