111111111111
100000000001
100000000001
100000010001
140040230001
100040000001
100010000001
100103000001
100000010001
100031000001
100000000001
111111111111
