111111111111
100010004001
140000000001
100300000001
100002000001
100030003001
100000000001
100040000001
100000000001
100100000001
100000001001
111111111111
