111111111111
100000000001
110000000001
100000100001
100004401001
110011000001
100000002001
100003000001
100003000001
100000000001
100000110001
111111111111
