111111111111
100000000001
100000000001
100000000001
140000000101
100000000001
100102000011
100000301011
100000000001
100001000001
100000100001
111111111111
