111111111111
114000000001
100000000001
100000400001
100000020041
100030030011
100003030001
104000000001
100000000001
100110000001
100000000001
111111111111
