111111111111
100004000301
100100000001
130000000001
100000010101
140002000011
100000100001
100000003001
100000000001
100000030001
100000004041
111111111111
