111111111111
100100020001
100101000011
100040000001
101000100001
100100000001
100003001001
101000100001
100000001001
100000000001
100000000001
111111111111
