111111111111
144300000001
100000000001
100030000001
100000000001
101001320001
100000300001
101000300141
100000000001
100400000001
140000001001
111111111111
