111111111111
100000000001
100000040001
100100000001
100400030011
100020300001
100010030001
100000001001
100000014001
100000000001
100010000001
111111111111
