111111111111
110000002001
100030000001
100000000001
100000101001
100000000111
100000400001
100100000001
101000000301
100000004001
100000000001
111111111111
