111111111111
100000000001
100000001001
100001004001
131110020001
100000000001
100000130001
140003000001
100031010001
101001000001
100000040041
111111111111
