111111111111
100000004011
100000000001
100000000011
100300000001
100004010001
100000300001
100001000001
100101020001
100000010001
110100000001
111111111111
