111111111111
100010000001
100100000001
100003000001
100300100001
100100010001
104000000021
100001000001
100011040001
101000000001
100000000101
111111111111
