111111111111
100000000401
100010000001
100003000001
100000000001
101010200001
140000300301
100000000001
100040000001
100000000001
100100000001
111111111111
