111111111111
110000000001
100100011001
100030000001
100000000001
100000000001
100010000001
100000000001
100000214011
100000000001
101001001001
111111111111
