111111111111
104000000001
100000000101
100000100011
101030020001
100001300001
101000300001
100000004001
100000000001
140000000001
101000000001
111111111111
