111111111111
100000000001
100000000001
100030000001
100002000001
100003004001
100001400001
100000001101
100000000001
100011100001
100000000001
111111111111
