111111111111
100001000001
100000000001
104000300001
101003000001
110001040001
100001000001
100100000011
100000000001
100002000001
100000100001
111111111111
