111111111111
100000004401
100000000001
100000000001
104000300001
100030302001
100030010001
100010040001
100000000001
100100000001
100000000001
111111111111
