111111111111
100000000001
100000000001
100000000001
100003001001
100000020001
100040000001
100000301001
140000000001
100100001001
100000101001
111111111111
