111111111111
100400000041
100000000001
100000000001
140002013001
100003300001
100000300001
100000100001
100000000001
100000001011
100110010411
111111111111
