111111111111
100000000101
104003000001
100000000141
104000000101
110000000001
100042330041
100003030001
100011000101
100000000001
100000000001
111111111111
