111111111111
100000000001
100000000001
100100000001
100302000001
110004000001
100410300001
100000400001
100000003001
100000000001
100000001001
111111111111
