111111111111
100000000041
100000040001
100000030001
100000000101
100300033301
100000300001
100040200041
100440000001
100000000001
100000000001
111111111111
