111111111111
100043000001
100000000401
100000000001
100013000001
100040003001
100000001001
100000000001
102000000001
100000000001
100000000001
111111111111
