111111111111
100100000001
100000000001
100000000001
100001004001
100100004001
100100000001
100003000001
100002030001
100000000011
100000100001
111111111111
