111111111111
100400000001
100000100001
100000300101
104113000011
100003020001
100000040001
101000000001
100000000001
100000100001
100000100001
111111111111
