111111111111
101000000001
100000000001
100100010001
100010002001
140000003001
100000003301
100000000001
100000000001
100100140001
140300000041
111111111111
