111111111111
100000004001
100000000001
100000000001
100000100011
100400300001
100210300001
100010000001
100000000001
100000000001
100000000001
111111111111
