111111111111
100140000001
140000010001
100000100001
100103300101
100000000001
100000000001
100300004001
100020000011
100001000001
100000000001
111111111111
