111111111111
140400101001
100003000001
100000000001
100000010001
100002000001
101010310001
100100000001
100000000001
100000000001
100000000001
111111111111
