111111111111
100001000001
100000000001
100000300001
140000000001
101000300001
121000000001
100400000001
100011000001
101100100001
100000000011
111111111111
