111111111111
100000000001
100000020001
100000000001
110000040111
100000000101
100030000001
100000001001
110000000001
140000030001
100000000001
111111111111
