111111111111
140000001001
100000000001
100000002001
100000300101
100000300011
100003000401
100300000001
100100000041
100000004001
100000034001
111111111111
