111111111111
100040101001
100004000001
100000000411
100030000001
100010330001
100000323001
100000301001
100040000001
100100010141
100000000401
111111111111
