111111111111
101000000001
100000000001
100000200001
100000000001
100000003001
100000000001
100000000001
100000000101
100000400011
100001000001
111111111111
