111111111111
101000000001
100000000001
100000021001
100003340001
100001004141
100000034001
100000040031
100300000001
101100000001
100000000001
111111111111
