111111111111
100101004001
100000000001
100000002001
100000000001
100000000001
100030000011
100010001001
101000000001
100000000001
100000001101
111111111111
