111111111111
100000000001
100000300001
100000000101
100040000001
100000000001
100000421001
100003000001
100010001101
110000000001
100000010001
111111111111
