111111111111
100000001001
110410004011
100001000001
100030000401
100000030101
110001412001
100004030001
100000000001
100330000001
101000000001
111111111111
