111111111111
100000000001
100000040001
100000400001
100000010001
100300030001
104000300001
100000000001
100100200001
100000000001
100001000001
111111111111
