111111111111
100140000001
100001000001
100302000001
101000003001
100040000001
100000000301
100000100401
103000000001
100400000001
140000003001
111111111111
