111111111111
100401000001
100000020001
100000000001
100000030001
100000030001
100000434001
111000000001
100000000001
100010010001
100000100001
111111111111
