111111111111
100000000001
100000001301
100010100001
100030041401
100010000001
103000000001
100200000001
100110041001
100100000001
100000010101
111111111111
