111111111111
101004010001
100040000011
100000300101
103000300101
100001000001
100010210011
100000040011
100000001001
100000100001
100000000001
111111111111
