111111111111
120000400001
100440000101
100000000001
100000030301
100000030001
140000330001
104101000001
113000000041
100000000001
100010000001
111111111111
