111111111111
101000000001
100001001001
100000000001
100003200001
100000001001
100000000301
104000300001
110000040001
100410000001
100011000001
111111111111
