111111111111
101400000101
100000030001
140000000001
100000000101
133020040001
100000004001
100000030001
100000000001
103040000001
100000000111
111111111111
