111111111111
104000002001
100000000001
101000000001
100000100001
100000000001
100000330001
100100000001
100000001001
110114000001
100100000001
111111111111
