111111111111
101400000001
100000010001
100000003001
100004003001
100440000011
103010000101
101020000001
100000000001
100000000301
100000000001
111111111111
