111111111111
110000110111
110110000101
100110110001
100000100001
100110020001
101110001101
100014011101
110000000001
110131010111
110000000011
111111111111
