111111111111
100011110041
100230110001
100100000001
110010311101
100000001101
101411100101
100011101101
110110000001
100000101111
100111100001
111111111111
