111111111111
100004110001
110010010041
110110000011
101110112001
100000030001
110000110011
100013110001
100000110111
101101000011
100000000001
111111111111
