111111111111
111100111111
110000111001
110110301011
110100001011
100110111001
100100100011
110010011001
110030110001
104400200111
111000000111
111111111111
