111111111111
100110101101
100110101001
110100100011
110000001111
110100021101
100113000401
100000110101
101010000001
101010011011
100000000011
111111111111
