111111111111
110000000001
100100000101
100111011101
100100000001
101101103101
101101100111
100000000001
100001120001
101101100101
111111100041
111111111111
