111111111111
100000000001
100000000001
100000000001
100000000011
100000000001
100000040001
100000003101
100002100001
100000000001
100000000001
111111111111
