111111111111
100000000001
100000000001
100000301001
110000000001
104000000001
100402010001
100100010001
100000000001
100000030001
100000000001
111111111111
