111111111111
100000000001
100000000001
100040030001
100010000001
100000400101
103102300001
100000000001
100010000401
100000000001
100000001001
111111111111
