111111111111
100000000001
100000000101
100030000001
100000000001
100040000001
100000003001
101000000001
100000400001
100110000011
100002000001
111111111111
