111111111111
100000000001
100000000001
100000000001
103033010001
100000010041
100400002001
110000001011
110001000001
100000000001
140000000001
111111111111
