111111111111
100000000001
100000000001
100000000001
100010400001
100000000001
100130400001
100320000001
100000000001
100000000001
100000000001
111111111111
