111111111111
100000000011
100000000011
100004030001
101000000001
100000000001
101000002001
100000010001
101000000001
100000000101
100000110001
111111111111
