111111111111
100010100001
100000000001
100010000001
100000000001
100430000001
100040000301
100020000001
100000000001
100010000001
100000000001
111111111111
