111111111111
100000000011
100000000001
100020000001
110000100001
100000100001
103040000001
100340000001
100000000001
100000000001
100001000001
111111111111
