111111111111
110000000001
100000000001
100010000001
100000300001
100140000101
100000000101
100000000201
100000000001
101000000001
100000100001
111111111111
