111111111111
100000000101
100001000001
100100000001
100003000001
100000000001
100000002001
100000000001
100000400001
100110100001
100000100001
111111111111
