111111111111
100000000001
100000000401
100400000001
101200000001
100000001001
103001000001
100030000001
100000000001
100000000001
100000000101
111111111111
