111111111111
100000000001
100000000001
100000000001
100000400101
100000200001
100000000001
100300100001
100010100001
110000001001
100000100001
111111111111
