111111111111
100000100001
100000000001
100410030001
100000000001
100302000001
100010010001
100000040001
100040000001
100003000001
100001000001
111111111111
