111111111111
100000000011
100001000001
101000000001
100000003001
100300400001
100014000011
100000000001
100000102001
100000000001
100000000001
111111111111
