111111111111
100000000001
100000010001
100000000101
100000000001
100030000001
100040110001
100010000101
100110002001
100000100001
100000000011
111111111111
