111111111111
100000010001
110001004001
100200003001
100400000001
100000300001
100000000001
100000300001
100000000001
100000000001
110000041001
111111111111
