111111111111
110000000001
100000000001
100000010001
100410010001
100000000001
103000200001
100000000001
100010000001
100000000001
100010000001
111111111111
