111111111111
100000000001
100000001001
101000000001
100003000001
100300000001
103000004141
101000000001
100000400001
102000000001
100000000001
111111111111
