111111111111
100000000001
100040001001
100000001311
100000003001
100000400001
103003000401
100000030011
140001100021
100000001001
100000040001
111111111111
