111111111111
100010000001
100000000001
100031030001
100000100001
100000004001
100000000011
100010010001
110000020341
100010400101
100000000341
111111111111
