111111111111
100000000001
100000000001
100000000001
100000400001
103000010001
100000000001
100000010001
100001000101
100020001001
100000000001
111111111111
