111111111111
100000000001
100000000301
100000100001
100404010001
100103000001
100300000001
101000000001
100000100041
100000020001
100000000011
111111111111
