111111111111
101000000001
100000000001
100000300001
104000000001
100000000031
100000000001
100000403001
101020000041
100000000001
100000000001
111111111111
