111111111111
100000000001
100000001001
100000000001
100340000301
100000410001
100000010001
100000000001
100000000001
100001200001
100001000001
111111111111
