111111111111
100000000001
100001000001
101000000011
100000000001
100000300001
100000000001
100000040001
100001002001
100000010001
100000000001
111111111111
