111111111111
100400300001
100100000101
100000003031
100001031041
100001300001
100000040031
130000240401
140430003101
100000004001
100000000041
111111111111
