111111111111
100000000001
100000000001
101000110001
100000000001
100004000001
100020100001
100000300001
101000000001
100000000001
101000000001
111111111111
