111111111111
100000000001
100000000001
100000301001
100401001001
101100003001
100000000001
104000100001
100000000001
100000100001
100020000001
111111111111
