111111111111
100140010001
100400000001
140100330001
101040040001
103000040001
100003040401
100000000301
130000000001
100230003001
100000000001
111111111111
