111111111111
100010000001
100000001001
100000001001
101030100001
100000000011
100000410001
110200000001
110001000101
100000000001
100001000001
111111111111
