111111111111
100000400001
100303003001
100000401001
100000001001
103000002001
100000040001
100000300001
100001043001
100004300001
104001000041
111111111111
