111111111111
100000000001
100001010011
100000000001
100000101001
100001101001
104003000001
100000030001
100000010041
100010020011
100000000001
111111111111
