111111111111
114000000011
104140000341
100000000301
100040000001
110000030301
110000000001
100000000001
100030000301
100000000001
101014000021
111111111111
