111111111111
100000000001
101000000001
100011300001
101011000111
110000000001
100000000301
100000004001
100000200001
100040000001
100000000001
111111111111
