111111111111
100000400001
101000000001
100000010001
103001000101
100000000001
100000000001
101100000001
100000000001
100100200001
100000000001
111111111111
