111111111111
100000000041
100000000001
100100030001
100040000001
100300040301
100000000001
100024000001
100300000001
100000001101
100000000001
111111111111
