111111111111
100000000001
100000000001
101000000101
101030000001
100000400001
100400000001
100200030001
100000000001
100000100001
100000000001
111111111111
