111111111111
100000010001
100000000001
103000000001
100030300001
100000101001
100000000001
100040000001
100002001001
100000000011
100400100401
111111111111
