111111111111
100000000001
100400010001
110400000001
100100013001
103000000001
100000000001
100003002001
100000040001
100000000001
100000000011
111111111111
