111111111111
100000000001
100001000001
100000010401
101430003001
100000000001
100000000001
100000300001
100402000001
100000000001
101010011001
111111111111
