111111111111
100000000001
100000103001
100110000001
100000100001
101000000001
100000402001
100440000001
110030000001
100003100001
100000000001
111111111111
