111111111111
100000010001
100001000041
100003000001
100000000401
100002300001
100000000001
100010000001
110000000001
100000010001
100000011001
111111111111
