111111111111
100004000101
100000000001
100000000031
101400000001
100300000001
103203000301
101004000041
100004010001
100000000001
100000000001
111111111111
