111111111111
100000000001
100010100001
100000400001
100000000001
100330003001
100000000001
100000000001
100000000041
100040000121
100001000001
111111111111
