111111111111
100000000001
100000000001
100000100301
110000000001
100000000001
100000100201
104000040001
100000003001
100000000001
100000010001
111111111111
