111111111111
100000400001
100000000001
101000000001
100000301001
100000000001
110100000001
100000000001
100034001001
100000000001
100000002101
111111111111
