111111111111
100000000001
100030000001
100000003011
100001040001
140321010001
100000010001
100041000001
100000110001
100300000001
100000000041
111111111111
