111111111111
100000000001
101000300001
100040040001
101000000001
100000400001
100000000001
100000000001
100000000301
100000032001
100010000001
111111111111
