111111111111
100000001001
100000000001
100000000001
100130100001
100400040001
100000030001
100000000001
100000004301
100000000101
100000000201
111111111111
