111111111111
100000000001
100000003001
111000400001
100000100001
100100003001
100000000001
140400000021
100001300101
100000000001
100000000001
111111111111
