111111111111
100000000001
100000000101
100000000001
100020011001
100040000001
101000000001
100000100001
100010300001
100000000001
100001000001
111111111111
