111111111111
100400100001
100000001001
100000100031
100000000301
100000000041
100400000001
100000000401
103300000001
100000020001
101000000001
111111111111
