111111111111
100000000001
100000000001
101000001001
100000011001
100000030001
100000000001
100004000001
100000012001
100000000001
100000100001
111111111111
