111111111111
100000100001
100100000001
100000000001
100440000001
100000000001
100004300001
100003000001
100002000001
100000000301
100000000001
111111111111
