111111111111
100100000001
100000030001
100000004001
100300000001
100004000001
100300000101
100000002101
100004000001
110000000001
100010000001
111111111111
