111111111111
110000000001
100000000001
100004001001
100001000001
100003000001
100000300011
100040000001
100000010011
100000020001
100000000001
111111111111
