111111111111
100001000001
100001010001
101400000001
100003303001
100000010001
100000000001
143000000001
100440000001
100000200001
100010000001
111111111111
