111111111111
100000040201
100400000001
100300000041
100000000401
100001000001
101300000001
103000000001
100001010001
100030000001
103000000401
111111111111
