111111111111
100000000011
101000000101
100004000001
100000001001
100001000001
100300001001
100000100001
100000100101
100002000001
100000000001
111111111111
