111111111111
100100000001
100030010001
110000000001
100011002301
100000000001
100001001001
100010040001
100000000001
110000000001
110000010041
111111111111
