111111111111
100000000001
100010000101
100010000001
101000011001
103000012001
100000000001
100001000001
101000000041
100000010001
100001000001
111111111111
