111111111111
100000000001
100001000001
100100330011
121030000001
104000000401
101100000001
100000000401
101000000001
100000100001
100101100001
111111111111
