111111111111
100000000001
100000001001
140001100011
100010000201
100000000001
100010000001
100000001001
100030000011
100000000001
100000100001
111111111111
