111111111111
100000000001
100000010001
100000000401
110303320001
103000001041
100000110001
100000000001
104044003001
100000000001
100000000101
111111111111
