111111111111
100000000001
101000000101
100000110001
110013120001
100000104001
100000100001
100000000001
101000100001
100000000001
100101000001
111111111111
