111111111111
100000000001
100000000011
101000000101
101030000001
101103002001
100040101401
100110000001
101000000011
100001010001
100000000011
111111111111
