111111111111
100001000001
100010004001
100302000001
100000000001
100000010001
100001000001
101000000041
100330000001
100000000001
110000001401
111111111111
