111111111111
100000000001
100000340111
100000000001
100000014001
110010000001
100033000101
100003041001
100000000201
100000000001
110041000101
111111111111
