111111111111
100001000001
110010004001
100000000001
100000000001
100000121101
100000010101
101000000301
100040030101
100010000001
100000003401
111111111111
