111111111111
100001100001
100000040011
100000001001
110100000001
100330001001
100000002001
100003100001
110000440001
100010000001
100000100001
111111111111
