111111111111
100000000001
101010000001
100032300111
100000000001
100000100001
100000100001
100011000141
100010000001
100100000001
110040000001
111111111111
