111111111111
101000400001
100100000001
100032100001
100000030001
100001040001
100011100011
100003000001
101100000001
100100000401
100100000001
111111111111
