111111111111
101000000001
100000000001
100004000001
101003002001
100300010041
100001010001
100010100001
101000000001
100000000001
100100000101
111111111111
