111111111111
100000000001
100000000011
100100000001
100000000001
100003100041
100002000001
100100100341
100000000001
100000000001
110101010001
111111111111
