111111111111
100000000001
111000000011
100030000011
101001000001
100030002001
100000101011
100000100101
100110001001
100000004001
101000041001
111111111111
