111111111111
101000001101
100000004101
100030300001
100001120001
100000001001
100000000101
101000000001
100000001001
101000000001
100400000001
111111111111
