111111111111
110000010001
100000000001
100000001001
100003012011
103000000001
100000001001
100100010401
100000000011
110000140001
110001000001
111111111111
