111111111111
100000010041
110000011001
100000000001
100030000001
100000120041
101000330001
101000100001
100004000001
100001001001
100000000001
111111111111
