111111111111
100001000001
100000000001
100000020001
100000001001
100010100401
100010100011
100000100001
100000010001
100000000301
100000000001
111111111111
