111111111111
100000100001
100000000001
110000301011
100103200301
100300000001
100100000001
100004001441
100001410001
100000100001
100100000001
111111111111
