111111111111
100000010001
100000001001
100000000001
103003012001
100000000041
110100000001
100000100041
101000001001
110000001001
110000000001
111111111111
