111111111111
100000000111
100010011001
100001000101
101000324001
100010000001
100010000001
100000130401
101100000001
110001000001
110000000001
111111111111
