111111111111
110000041001
100001010001
100001003001
100002001001
100100000001
100000000001
100100001001
110001000001
100000001001
100000100001
111111111111
