111111111111
100100000001
100000000001
103000040001
110000000001
101010000001
100000020041
100030110001
100000000001
100100000101
101001000001
111111111111
