111111111111
100010000011
101000000001
100003020001
100000010001
100000010001
101001100011
100000000111
100010000001
100040000001
100000000001
111111111111
