111111111111
100000010001
100001000101
101002030001
100000000001
100101000001
100000030041
110000000401
100010000001
100000000001
100000000001
111111111111
