111111111111
100010001001
100000010001
100010101001
100003200011
100101000011
100000000041
100031000001
100000041001
101000000011
100000100001
111111111111
