111111111111
100040001011
111000100001
100000100001
100000000001
100100213001
100003010001
100000010001
100000001001
101000000001
100000004001
111111111111
