111111111111
100000000011
100000000001
100000000001
100000010001
110010020001
100300000011
100000110041
100000000011
100010000001
110000001001
111111111111
