111111111111
100004010001
112013001001
110100000001
100000030101
100000100001
110104000001
100001400001
100003001001
101000000001
101000000001
111111111111
