111111111111
100100000001
110002001011
100000100001
100000000001
100000010001
100003300001
100000004001
100010000001
101004000001
100000000001
111111111111
