111111111111
100000000001
100000100101
101000010101
100000001001
103004000101
100103034001
100000100001
100000000001
100000000001
100040020111
111111111111
