111111111111
100000000011
100010100001
100010000001
100003000001
100000040001
110020010411
100011001001
101100300001
100000000001
100000000001
111111111111
