111111111111
110100010001
100100000101
104000000001
100130000001
100002000001
100000101401
110000000401
100000300001
100300010011
100000000001
111111111111
