111111111111
100000010001
100000000101
100000100001
100032110001
100030000441
100000000141
100000000001
101000100001
100000000301
100001010011
111111111111
