111111111111
100010100001
100000000001
100100000101
100000010001
101030000001
110010004001
100000021001
101013001011
100400000001
100000000001
111111111111
