111111111111
100001010001
101000000001
100000330001
100030000001
101020000001
100004000041
100001004001
101000000041
101000300101
100010000001
111111111111
