111111111111
100000000001
101000000001
100042000001
100000000001
100030040001
100003000001
100000000001
100000100001
111100000001
100000000011
111111111111
