111111111111
100000000011
100000101001
100000000301
100030000011
100000100001
100000001141
100000010001
100000010021
100000000041
100000000001
111111111111
