111111111111
100000000001
110040000001
100040102001
100000000001
100001000001
100033000001
100030000001
100000400101
100100000001
100000000001
111111111111
