111111111111
100001000001
100000001001
104002000001
100301000001
100000003001
110001100001
103000000001
100040000001
100100400001
100000010001
111111111111
