111111111111
100000100001
100000000011
100000000001
100002000011
100030010001
100000000001
100000010001
100000000401
111001101001
100000110001
111111111111
