111111111111
100000100111
100000004001
100010000011
100103201001
100000000001
100000000011
100010110001
100000010011
100000000001
100100000001
111111111111
