111111111111
100000010001
100000000001
100000000001
100000200001
103000000041
100000000001
100000030041
100000000001
100000010001
110000000001
111111111111
