111111111111
100000000001
100000000001
100030010001
110012000011
103000100401
100000000001
100400010001
100000010001
100000010001
100110100001
111111111111
