111111111111
100000000401
103001000111
110002000001
100000100001
100000003001
100101000001
100004000101
101001000101
100001010011
110000000001
111111111111
