111111111111
100000000001
101000000001
100033001001
100003100001
100002000001
100011000001
100040114401
100000001001
100000000001
100000001001
111111111111
