111111111111
101000000001
100000010001
100000001011
101000000001
100103030001
100110000001
100000200041
100000010001
100000000041
110100000001
111111111111
