111111111111
101000101001
100000001101
100002000001
100010000001
103010000001
100300411011
100004000101
100000000001
100011010001
110000000001
111111111111
