111111111111
100010001001
100000000001
100000000001
100000000011
100132300001
100000104001
100100010001
100011000401
100000000001
100000000001
111111111111
