111111111111
100000000011
100000000001
100000020101
100001000001
100000010001
100000304001
100030104011
100000000001
100000011001
110000000001
111111111111
