111111111111
100104000001
110000000001
110010003001
100020100001
100000010001
100100000001
100000000001
100100041001
103000100001
100010111001
111111111111
