111111111111
100000100001
100000000111
101001000001
101000412011
100000000001
100000300001
101000111001
100100000101
100000300001
110000410001
111111111111
