111111111111
100110001001
100000300001
130000000101
100000001001
100000024011
140000000011
100001001401
100000000001
100000300001
100000000001
111111111111
