111111111111
101001100011
100000000001
100000000101
100000000001
100032000001
100001000001
100000100111
100010010041
100000000001
100000000001
111111111111
