111111111111
101000000001
100000100001
101010040011
100001000001
101100000101
100000000001
100314001001
100001300001
101001001001
110000010021
111111111111
