111111111111
100010000101
100100001401
100000000001
110000010001
100003200001
100010000101
100000301001
110001100401
100000000011
100000000001
111111111111
