111111111111
100011000001
100000000011
100100310011
103000200011
100100100001
101000010401
100000000001
100001000101
100000000041
100100000001
111111111111
