111111111111
100000000001
100000000001
100001100011
103003203001
100001001401
100000000001
100000100411
100410011001
100001000001
100000000001
111111111111
