111111111111
100000000101
100000000001
100002000011
100000000001
100030000001
100000004041
110000000001
100300000001
110000101301
100004100001
111111111111
