111111111111
101000040011
100000000011
110000000001
100300010001
100403200001
100303000001
100000000001
140110100401
110000000001
100100000101
111111111111
