111111111111
100000010001
100000000001
100300044001
100032011001
101000000001
100100010001
100000000001
100000000011
100000000001
100000000101
111111111111
