111111111111
100000000101
100000000001
100000200001
100103300001
100000000001
100000000141
100000100041
100010001101
101011000001
101000001001
111111111111
