111111111111
100000000001
110000100001
100000200001
101100000001
100000100011
100010043001
100000000401
101003000011
100100000001
100000000111
111111111111
