111111111111
100000400111
100100100001
100000000001
101132000011
103000000001
100000000001
101000030401
100000001401
100000000001
100000000001
111111111111
