111111111111
100000100001
110000030001
104000100001
100010021001
100000000001
100000014011
100000014001
100003000001
100003000101
100001000101
111111111111
