111111111111
100000004011
100000400001
100300000001
100030001101
100000010001
100000010001
103003000201
100100000001
140100000011
100000040001
111111111111
