111111111111
100000000001
100000000101
100033320001
100000100001
100000000001
100000000441
100000014001
100040000001
110000003001
100000000001
111111111111
