111111111111
100001000001
100001000001
100003200011
103010100001
100000000011
100010010001
100000000401
100000400001
100000100001
100000010001
111111111111
