111111111111
100000001001
100000100001
100032000001
110010000101
100000004001
100100000001
100000000101
100000000001
101000010001
100000000001
111111111111
