111111111111
100000000001
100010000001
100100030201
100000100001
100030000101
100000000001
100000400001
100003001401
110000040001
100100000001
111111111111
