111111111111
100110010001
100000000101
100300000001
100000020001
101000401001
110000010011
101000000401
100003000101
110000000001
100000001001
111111111111
