111111111111
100000010001
100000000001
100000120001
100100001001
100011110001
100100010001
103000000001
100010110041
100000000001
100001000001
111111111111
