111111111111
100040001001
100000000001
100000100001
110033230001
100000000001
100101000001
100010004401
101000001001
100000000001
101000110001
111111111111
