111111111111
100000000001
100110000001
110000000001
100310020011
110000101301
100010000001
110000000041
100000000011
100000400001
100000000001
111111111111
