111111111111
100000011001
100001010001
100001003011
100001200001
101010000001
100300000111
100011040001
100000000001
100000000001
100001000041
111111111111
