111111111111
101100000001
100000000001
101101000101
100000300101
100003000001
100000114001
104010100011
100210000001
100000111001
100100000101
111111111111
