111111111111
100000000001
100001101001
100011100011
100140300001
100200410001
100100300001
100034103001
100000000001
100100000011
100000401001
111111111111
