111111111111
101000000001
100010111001
100300040001
100100400001
100013001001
100003040001
101100434001
100001230301
100000410001
100000000001
111111111111
