111111111111
100000000001
110003000001
101001100101
101100001101
100000330401
100010100001
100040000001
100001110001
101423004001
110000000001
111111111111
