111111111111
100000000001
100100010001
100140414011
100103000011
100010000301
103100043001
100332000301
100141000001
100300440101
100000004011
111111111111
