111111111111
140000000001
100000100011
100000030001
131010411001
100001004001
100311000301
100020000001
110101411001
100000000001
100004300001
111111111111
