111111111111
100000000001
100100101011
101030100041
100010000011
100040101011
103204030001
104100130101
100010400001
100000310101
100000000001
111111111111
