111111111111
100000000011
100104010001
100330000011
113000003001
100000100001
110000000001
100041031101
143000000411
100104000001
140000121101
111111111111
