111111111111
100000000001
100110000001
100010111001
100100000011
100200000341
100300010301
103010404001
103010000001
104010100001
140000000011
111111111111
