111111111111
140000000011
100110010001
100000000001
100030021111
100300040041
100000101401
110003101031
100030114001
104030000001
100001100001
111111111111
