111111111111
100010100001
100010000001
100100003001
100100000001
100140000101
102300000401
103040003101
111040400001
100000000301
100001100001
111111111111
