111111111111
100011100001
100010000111
100010100011
100001100001
110300001001
114000310001
100010230001
104001400101
100000000101
100001000001
111111111111
