111111111111
100040000101
100000000001
100000000001
100400011001
100000010001
113311300301
100021003001
100410410401
101000003001
100000400001
111111111111
