111111111111
140100000001
100100000001
100000000001
100033100001
101020014011
100044300011
100100030001
130011301001
140000040001
100001000001
111111111111
