111111111111
100000001001
100101000001
100001110001
100000300011
100000010001
102333041001
141010400001
110000000001
100000410301
140000000001
111111111111
