111111111111
100011000001
113004000001
100000003001
100001000101
100000400001
133200003001
140011101001
100104041011
100340001001
100000000001
111111111111
