111111111111
101000110111
100011000011
111001010111
100000000001
100011100001
111111001011
100000111001
100120030001
100100004111
100000000001
111111111111
