111111111111
100000000001
101111001011
101110011001
100000000011
101104211011
101101011001
100001011001
101030001011
100101100011
110000000011
111111111111
