111111111111
111002111011
110000100011
110101001011
100000001011
100001100001
100001013001
101111010101
100110000011
104000000011
100010110011
111111111111
