111111111111
111130013001
110030011011
100301000011
100001111011
110100000011
110205100011
110111100301
100111000111
100003300111
101111130411
111111111111
