111111111111
100203111011
100000010001
100111000011
100111000011
100305110011
100140110011
100110110011
110310303001
110000000011
110101111111
111111111111
