111111111111
150112105101
110030000001
100000000101
110011111101
110010001301
110041100001
110011101011
100111001011
130000000011
111110103011
111111111111
