111111111111
101101111511
100030011011
111010001011
100110011001
100411001051
100101100011
100100100011
100000112001
100100000111
111110110111
111111111111
