111111111111
103103110011
100000000011
130101210011
100100110011
100101101011
100101000011
100001101031
100401101011
100000000001
101111100101
111111111111
