111111111111
100011230001
110003003001
111003014001
111003110011
100000100001
100101113001
100101110001
100100000011
113000003001
111011101111
111111111111
