111111111111
110111411101
100000000001
111001111101
100000001101
110011100301
110000002501
100011115101
110011111101
113000000001
111110111031
111111111111
