111111111111
111001111011
103020000051
100000300011
110001110111
110011110111
113011100001
110011110101
101011100001
100014000111
111011000111
111111111111
