111111111111
115300001111
100513000011
100110100041
110111110111
110102100001
100000110511
110100110101
100105010001
100300000101
101011110101
111111111111
