111111111111
100001000001
100000200101
100000001001
100000030011
100000000101
100000000001
100000300001
100110000001
100000014001
100000004001
111111111111
