111111111111
100000010001
100000000001
104000000001
100100000301
100000002001
100000300401
100030001141
100001000001
100001000001
110100000011
111111111111
