111111111111
100004010001
100010000101
100000010301
100001000201
100000000011
100030310001
100001000001
100000000001
100000400401
100100000001
111111111111
