111111111111
100000000101
100000004001
100000011001
100000100001
101004033001
100420330041
101000300001
100010000011
100004000001
100100000001
111111111111
