111111111111
100000000001
110100000001
110004000101
100000000001
101013000001
101010301001
101000110001
100000100001
101000000401
121003040001
111111111111
