111111111111
100000000001
100000000001
100100000011
100001201001
100040400001
100030300301
100300000001
100000000001
100000000001
140000400001
111111111111
