111111111111
100000000001
100000100001
100000001001
100000000001
100000003001
100003244001
100103000001
100000000001
100000001001
100001000401
111111111111
