111111111111
100100000001
100401000101
100001100101
100100000041
100003300001
100023001001
100000000001
100000000001
100000004001
100000000011
111111111111
