111111111111
100000000041
100000001011
100000030001
100000000001
100000001001
100000000001
110140200001
100100300001
100000000101
100000000001
111111111111
