111111111111
101000000001
101010000101
100010000401
100000300001
100000000001
111032300001
100000000011
100004000001
100001000101
100000004001
111111111111
