111111111111
100000000001
100000000001
100000000001
100040200001
100000300001
100043000001
100100030111
100001100001
100000000001
101000101041
111111111111
