111111111111
100000000041
100001000041
100000000001
100001100031
100002000001
100300000001
100010101001
100000010001
100000001001
100000001101
111111111111
