111111111111
110000000001
104000004001
100001010001
100000000101
100033304011
100030000011
100030000001
100010000001
140000001041
110201000011
111111111111
