111111111111
100000000001
100000030001
101001000001
100000000001
100010001001
100003200401
101110004001
100030100011
100004000001
100100000001
111111111111
