111111111111
100000000101
100003004001
100000101001
100000000101
140000000111
101030000001
100000001001
100000100301
101000000021
101001000041
111111111111
