111111111111
100100000401
140000000001
100003000001
110003000301
101000200001
100000000001
100004013101
100001400001
100001001101
100001000001
111111111111
