111111111111
100000000011
100000001111
100000300001
100000000001
101104000001
110002000001
100000000041
100000301001
101001000001
100000000001
111111111111
