111111111111
100000000001
100000400001
100400101001
100100300001
100000300001
100033020001
101000000001
100010000401
100040000001
110000000001
111111111111
