111111111111
102001000001
100010000011
110000000001
100000300301
104000330001
100000001101
100100001001
100000040401
100400100101
110000010001
111111111111
