111111111111
110000010341
100000000401
101000000101
100113000101
100400300001
100000204101
100030001001
101000000001
100000000001
100000000001
111111111111
