111111111111
100000001001
100000000011
101000001001
100000000001
100003200001
100000000001
101010300001
100000004001
100000141001
100000000001
111111111111
