111111111111
100000000001
100100000001
100000000001
100000201001
100400340001
100000100001
100000300101
100100300001
100000000041
100001100001
111111111111
