111111111111
100000000001
100000000001
100000300001
100003000001
100100340001
100010240041
100000000101
100000000011
140000301001
100000000101
111111111111
