111111111111
101010000001
100000000001
100001100101
100000010201
100000310001
100030000041
100010000001
100100000001
100100040011
100110000001
111111111111
