111111111111
110000000011
100000000001
100000100001
100000200001
101000000001
100030044001
100030100001
100000000101
100010000001
110010000001
111111111111
