111111111111
100000000001
100000000001
100001000001
100001000001
100010000011
100203334401
100003000001
100000004001
110000001001
104110001001
111111111111
