111111111111
100010000401
100000041001
101000001001
100000000001
100000000311
100300230001
101000100001
100000000001
100100400001
100001001001
111111111111
