111111111111
100000000001
100000100041
100310000001
100001000001
100010100001
100000003001
100102101001
103004000041
100100001001
100000000001
111111111111
