111111111111
100100000001
100000010011
100101000401
100100000001
101021030311
100040300001
100110000001
100000001041
100000000011
100000000001
111111111111
