111111111111
100000001001
100400001101
100000030001
100001030101
100000200011
100004300001
100100001001
100000000011
100000000001
110400000011
111111111111
