111111111111
100000000001
100000112001
100300000411
100001100001
110040000301
100004000101
100030000001
100000000001
110000001001
100000001001
111111111111
