111111111111
100000000001
100000000101
100000000011
100004000001
100000000001
100020400101
103000000301
100100010001
100000000001
100000000001
111111111111
