111111111111
100000100001
100000000001
101100111001
100013000001
100000300001
100002000401
100400000401
100003000001
100010100001
100000000001
111111111111
