111111111111
100001041001
100000000001
100000000001
100400000001
100332001001
100003000001
100000000001
100000000001
100000400001
101000000111
111111111111
