111111111111
100000000001
100000000001
100000001001
100000000001
100003004401
100103240001
100013304001
100000000001
110000000001
100000011011
111111111111
