111111111111
100000000001
100000100101
101010000011
100003010001
100120400001
100001300001
100010000101
100000000001
100000000001
104001010001
111111111111
