111111111111
110000000001
100000300001
103001040001
100000000101
100010000001
100024400001
100000000001
103101000101
110001000001
100000000011
111111111111
