111111111111
101100000001
100100000001
100000000001
100000011001
100003000001
100302000001
100100000001
100000011101
100004040001
100000000001
111111111111
