111111111111
101011001001
100000003001
101200000001
110000000001
100001000001
100000010401
100003030401
100400000001
100000100101
100000010011
111111111111
