111111111111
100000040301
100100100001
100000000001
103000040001
100000000001
100100230101
111000000001
100001000001
100000000101
100000040001
111111111111
