111111111111
100000400001
100000000011
100000000001
100000104001
100030201301
100030000001
100300400001
100000001001
100000040001
100000100001
111111111111
