111111111111
100001000001
100040300001
100000000011
113000000001
100003002401
101003410001
100000001101
100001000401
100000000001
100100001001
111111111111
