111111111111
100000000001
101000401001
100000000001
100000000001
100003300001
100030140001
100100200001
100000001001
110000040001
110000000001
111111111111
