111111111111
100100000011
100000000001
110000020001
100040000001
100000400001
100030300001
100003000001
100000000001
100001000001
101000004001
111111111111
