111111111111
100000000001
100000000001
100001400001
100131100001
140100010001
113000000001
110000200301
100300400001
110010000001
100000000401
111111111111
