111111111111
100000010001
100000000001
100000300001
110000000041
100000040101
100100200011
100000301001
100040300001
100000100001
100000000001
111111111111
