111111111111
100000010001
100000000001
100000000001
100100000001
100030301401
100000240001
100000000001
100000100001
100000000001
100000100101
111111111111
