111111111111
100111000001
100000000001
110000000001
100000101001
100003300401
100000003001
100000200041
100100000001
100100000401
100000001001
111111111111
