111111111111
100000000001
100000300001
100000000011
100000001001
100000001041
100002140001
100000300001
100000001001
100000001001
101000000001
111111111111
