111111111111
100000000001
100010000001
100010000001
100000000001
103000012001
100000400001
100010103001
100000000041
100001000001
101000000001
111111111111
