111111111111
100001000001
100000000011
100000030041
100000001101
110000010001
100002400111
101000000001
100310001011
100001010001
110000000001
111111111111
