111111111111
100001000001
101000000001
100000100001
141004003001
100002001001
101030040001
110300001001
100000000001
100300001001
100000400001
111111111111
