111111111111
101011000001
100000000001
100004010001
100010000001
100000040001
100030000001
100000200001
100000300001
100100000111
100001000001
111111111111
