111111111111
100000000001
100000000211
100400100001
100000001101
100000300001
100030000001
100140300101
100100000001
110400000001
100000001001
111111111111
