111111111111
100040000301
100000000001
100000030001
100000300001
100020000041
100030000001
100100000041
101010000001
100000000001
100011004001
111111111111
