111111111111
100000000001
100003000001
100000001001
100100000101
100000000001
100000020401
100000300101
100400000001
100000000001
100000000001
111111111111
