111111111111
100001100401
100000410011
100000001001
100030000301
100003000001
100000204001
110000031001
100000400111
100000000001
110010000001
111111111111
