111111111111
100000000001
100000300001
100000000001
100000330001
100010000001
100004440001
100000200001
100100000001
100000000001
100000000001
111111111111
