111111111111
110004000001
100000000001
100001000001
100003300001
100000300001
100003000001
101000020101
100104140401
100000000001
100000010001
111111111111
