111111111111
100000000001
100000003011
100000000001
100001000101
100010120001
100000040301
140100100001
143010340001
100000103001
100000110401
111111111111
