111111111111
100010000001
100000000001
100110000001
110003000001
100031040001
100000214001
100000300001
100010400011
100000000001
100100000001
111111111111
