111111111111
101000000001
100001100001
100100300001
100000000001
100000000001
100034020011
100010004001
100000300001
100000000011
100000000041
111111111111
