111111111111
100000001001
100000000001
100000110001
100004020001
100100000001
100003040001
100030001001
100000000011
100001000011
100000010001
111111111111
