111111111111
101100000001
100000000001
100400000001
144000000011
110130200001
111000004301
111000000001
100003300001
100000000101
110100000001
111111111111
