111111111111
100000000011
110100000401
100000000001
100001000101
110010001001
100030300011
140003000001
100100000011
101100200001
104000010001
111111111111
