111111111111
101000000001
100001030001
100000000101
100013000001
100000010101
100000414011
100000000001
100000000001
101021000001
101100000001
111111111111
