111111111111
100004100001
100010000001
100000000111
100000100001
100000300011
103000043101
100000000001
100002000141
101010000001
100000000001
111111111111
