111111111111
100111000001
100000010001
100000000001
101101000001
100101130011
100000200001
100001141001
101100100001
101000100001
111000111001
111111111111
