111111111111
111110110011
101100000001
100000000011
101111104011
100004010011
101011010011
101002300011
100010130011
100000000001
100010011101
111111111111
