111111111111
111111000001
100110031001
110110000001
110000001001
100010410001
110020110001
111000110101
110010010001
110110110101
100000000001
111111111111
