111111111111
100100100001
100000000101
111101140101
112000100001
100010101001
111000100001
110000300101
110001100101
100011100101
101000000001
111111111111
