111111111111
100000000001
104010100101
100000300001
100001000101
101301110001
103211043001
100401004101
100001003001
101004001001
100000000001
111111111111
