111111111111
100000001001
110000000301
100000000001
100031031101
141400000141
101000001001
100040300101
100030300001
100000000201
101144111011
111111111111
