111111111111
100000000001
101001010101
100011010001
100400003001
103001030401
100000030001
101001001041
102000100001
100003100041
140000000001
111111111111
