111111111111
100000000001
100010000001
100010100001
100330004301
100004330401
101131040101
101100000101
100014240101
100000000001
100000000001
111111111111
