111111111111
100100000001
100000000001
100014310101
100011000001
101100044001
100004030001
100000030001
100413200001
100030100001
100000300041
111111111111
