111111111111
100010000001
100010100001
100000000101
100004100041
100100100101
101033403401
100441003001
100100000001
100300033011
100000200041
111111111111
