111111111111
101000000001
101001400311
101011000001
100111100001
100300100001
100010300001
101000410001
100010004101
100002000001
100000000101
111111111111
