111111111111
100000000001
100111000101
100100010301
101100004001
101000101001
101301400001
100411000001
100000002101
100400330001
100001000001
111111111111
