111111111111
100000000001
100140001001
100030004001
100000001101
101001100001
101100030001
100010203001
100000011101
100000400001
100000030041
111111111111
