111111111111
100000000001
101111000001
100100301011
100030011401
104030004401
104130000001
100140000101
100030200001
100003300011
100000001401
111111111111
