111111111111
100001000001
100003300001
100014401001
101100101001
100013100001
100004400001
100303000001
100000404001
100200013001
100000340001
111111111111
