111111111111
100000000001
100100001001
101400001001
100301003001
104040000001
100001100011
103000023001
100004000101
100001010001
100000000111
111111111111
