111111111111
100010000001
100110100001
100100100041
100300100001
140001034111
100000103001
100003120041
101000300001
100010010001
110000110041
111111111111
