111111111111
100000000401
100000010101
100010000001
103000100001
100203300101
100010010101
100001040001
104000100001
100000100011
100000010001
111111111111
