111111111111
100001000001
100100000001
100001000001
100100100001
100000000001
100120001001
100303040401
100301010001
100000014101
100000000001
111111111111
