111111111111
100000000001
100010001101
100000000001
100002000101
100414003001
100000103001
100000131041
101314000011
100300400111
100000000001
111111111111
