111111111111
100000000011
100011000001
100001110101
100010000041
101000030301
104000000001
100110000001
100040000001
100002030001
100030400001
111111111111
