111111111111
100000000001
100010000001
100430004401
100000041001
100002030001
100000003011
103010003001
100013100001
100004000011
100040030041
111111111111
