111111111111
100000000001
100103000001
100004000001
100020011001
101100000001
100000143001
100000001001
100300000111
140001100001
100000000001
111111111111
