111111111111
100403000001
100140001001
100030011001
100300000001
100010003011
100000101001
111020100101
100000000101
100040000001
100400110001
111111111111
