111111111111
100000000001
103001000101
100000000001
110100403041
140303004101
110000100001
143440400131
100020003001
103000101001
101000000001
111111111111
