111111111111
100000000001
100000401101
100100000001
104030000301
101140100001
100321000001
100104000001
100300000001
100001101001
100000000001
111111111111
