111111111111
100000000001
101000000001
100000410011
100101000011
101000003041
100003144301
100030000001
100010001001
100012000001
100043000001
111111111111
