111111111111
100101010001
100100410001
100141000011
100031001001
101100030001
100010030011
101000110301
101101000041
100140020001
100000000001
111111111111
