111111111111
100000000101
100004040001
101113010101
100000100301
103041103301
100004003011
100042300001
101040400001
100101110001
100000000001
111111111111
