111111111111
100000000001
100110001011
100101010001
100100010001
101000000001
100000000401
100003100011
100000401001
100013200001
100000000001
111111111111
