111111111111
100000000001
100011413001
110100000001
110000010101
100200010001
100111010101
100103001101
100101001001
100004000001
100000001101
111111111111
