111111111111
110101011001
110000000001
100010210101
101001010101
100000000001
101113141011
101100001011
101101100001
100000011011
101000000001
111111111111
