111111111111
100000000111
100110000011
100010410011
100010010011
100010030001
100120010001
100000000011
111100111001
100000100101
100000000001
111111111111
