111111111111
100100000041
100001100011
101110000401
100000030001
100001010101
100102010101
100104310001
100103010111
100100000001
100000000001
111111111111
