111111111111
100110000001
100001100001
100000400001
111000200001
100010111101
111030000001
110011100001
110000000001
110010001101
100000000001
111111111111
