111111111111
100000000111
101111020001
100000400001
103000001101
101010100001
100010100001
101100101101
100100001101
100000000001
101011000001
111111111111
