111111111111
100000000011
100000000001
110111100101
100003010101
100210000001
100111000001
100000011401
101100000001
100000000111
101111110111
111111111111
