111111111111
100000000001
100101011001
110001000001
110000011001
100101100001
100000020101
100011040001
100100000001
110101113001
110000000011
111111111111
