111111111111
100000000011
101100011001
100000000211
100301100041
103110110101
103400100101
100100101101
100100100001
100001001011
104101111001
111111111111
