111111111111
110000000011
110001110011
110001110001
110000000011
100010000001
110013010041
110000000111
100011110011
110000200001
110001100001
111111111111
