111111111111
100000000011
110041102001
110001100001
100101101001
100000000001
110000001101
110111100001
110300000001
110100001101
100000000001
111111111111
