111111111111
100010011001
101003401001
101100100001
101000100001
103400200011
104100010001
100000310131
100030430001
100004110041
100000000001
111111111111
