111111111111
100010000101
100000000001
100000010001
100100100141
103400034031
100100130001
103100000301
100000002001
101404300001
100400000041
111111111111
