111111111111
100000000141
101110001101
101000000001
100011000031
100001100001
100101010011
100402000011
100111010001
100100310101
110001000011
111111111111
