111111111111
100000001001
100000101011
100011111001
100010304001
101000040001
101100000001
100003000011
113020000101
104000000001
101001140301
111111111111
