111111111111
100000000001
100000000001
100100000041
100000001001
140110100301
100003010031
101300314001
103024400341
100000000101
100000140001
111111111111
