111111111111
140030111001
101110000001
100100004001
140000111101
100000000001
101100000141
101103100001
100100300111
101103000011
100020001001
111111111111
