111111111111
100110011141
100000000001
100000301001
100011100001
101400010001
100000000301
101010000101
101001100001
101030142011
100010001001
111111111111
