111111111111
100000000001
100010100401
101010000401
103000013001
100100110001
100000034011
100440101301
100000432001
104301001301
100000000001
111111111111
