111111111111
100000000001
140000000001
100000003001
100000000401
103000002001
110000001001
100000001001
100000000001
110100000001
100100100001
111111111111
