111111111111
100004004001
100030000301
100030000001
100001200001
100310000001
101000103001
100000000001
114000040001
100000000001
100000400001
111111111111
