111111111111
100000001001
114000000101
104110000101
100000000001
100003200001
100100030101
100000100001
101101100001
100010100001
100000000001
111111111111
