111111111111
100000000001
101400000001
100004000301
100401100001
143002003001
100031030041
140001000101
100001000301
100304000001
100000000001
111111111111
