111111111111
100100010001
100000000001
141000000101
100000000001
100403002001
100001000001
100000000011
100000003001
100001001001
101001000001
111111111111
