111111111111
100010000001
100000000001
140000100111
110400000011
100112300011
100010030001
100000000101
110000000101
100001000001
100000000001
111111111111
