111111111111
100000000001
100010401001
100000000001
100000000001
100003000001
100000002001
100004030001
100000000011
100000040301
100000000001
111111111111
