111111111111
100000000001
140001100011
100000041001
100000000101
100000000001
100000300011
100013100001
100000210001
100100000001
100000001001
111111111111
