111111111111
100001000001
140000000001
104000010001
110000000001
100000200101
100000300011
100000030001
110000100001
100000100001
100000000001
111111111111
