111111111111
100001100001
140000110001
140000000101
100000000001
110000001001
101030300001
101100000101
100100020001
100000000101
100000000001
111111111111
