111111111111
100001000101
100000100001
100000000001
100000010001
100103201111
104000000301
100000000001
104100000101
100000100001
100000001001
111111111111
