111111111111
100000000001
100000400001
100000000001
100000000001
100140030011
100020000001
110000003001
100000000001
101000000001
110000010001
111111111111
