111111111111
101100000001
100000000001
140000000001
104000000111
100000001001
100000302001
100003000001
100000000001
100000000011
100000000001
111111111111
