111111111111
100001000001
140000000001
100002030001
100001000011
104000001001
100003400001
100000003001
100000000001
100000001001
100000000001
111111111111
