111111111111
100004000001
140000000001
100100100301
110030000001
100000200301
101000000001
110000000011
100030000101
100000000401
100004000001
111111111111
