111111111111
141000000001
100000000001
101000000001
100002300001
110001000001
100000000001
100010100001
100010000001
100000000001
100000000101
111111111111
