111111111111
100000000001
140100011011
140100000001
100000000001
100000300001
100002000001
100000030001
100000100001
101000000011
100000000011
111111111111
