111111111111
100000000011
101400000001
100000030001
100000000011
100300004001
110000000001
101030420001
100001000001
110000000001
100000000001
111111111111
