111111111111
100100000001
100000100001
140000000011
140000000001
100000200011
100000113001
100003000001
100000100001
100010000001
100000000001
111111111111
