111111111111
140101000001
100001010101
100000001001
100002300011
101000000001
100000000001
100000001001
101000000001
100000000001
100000000001
111111111111
