111111111111
104000000001
100001010001
140003000001
100000020011
100000000001
100001000001
100000000001
100000030001
100100000001
100000000001
111111111111
