111111111111
100010000001
104000000001
100001000001
140000000001
100030000011
100000301001
100100020001
100000110001
100000000001
100001000001
111111111111
