111111111111
100010000001
100010000001
100004100001
110002000001
100300001001
100040000001
100000000301
100000000001
100010000001
100000000001
111111111111
