111111111111
100000000101
100001000101
103300000301
140401000001
100000200001
100040000001
140000000001
100040003001
100003000001
100000000001
111111111111
