111111111111
100000100041
104000000101
100030000001
110000300001
114000000011
100010001001
110100000111
100003000011
100000120101
100000000001
111111111111
