111111111111
104000100001
100000000101
100000000001
101000000001
103030000001
100000000001
104000000001
100000210001
100000000001
100000000001
111111111111
