111111111111
140000000001
100000000001
100000000001
100000000001
100020131001
100000300001
100000000001
100000100001
100000000001
100001000041
111111111111
