111111111111
111101000001
104100000001
100010001101
100000000011
100020000001
100000031011
100000100001
100030400001
100000000001
100000000001
111111111111
