111111111111
100000000001
100001000011
104000100011
140000111001
100003300001
100000200001
100000100001
100000000001
100000100001
100000000001
111111111111
