111111111111
100001000001
140001010001
100000100001
100010100001
100100000001
100000301101
100000200011
100000000001
100100000001
100000000001
111111111111
