111111111111
100100400001
110000000001
100100000001
100030000001
100300000001
100000010001
100300020001
100004000001
100000040001
100010000001
111111111111
