111111111111
100000000001
140000001001
101000000101
100000101001
100000301001
100000020001
101010110001
100000011001
100000001011
100000000001
111111111111
