111111111111
140000000011
100014000001
100000000001
100000000101
100000300001
110100031101
100000200101
100000010001
100000010001
100000000001
111111111111
