111111111111
100000000011
100000010001
100003000001
100000020001
100000001001
100003000001
100010000101
100100401001
104000000001
100001000001
111111111111
