111111111111
100400000001
100000000001
100013000001
101030100001
100000001101
104100000001
100002000001
100000000001
100000100101
100000000001
111111111111
