111111111111
100001000001
100000100001
100010000001
100000010001
110003430001
100000002001
100000000001
100010000001
100000004001
110000000011
111111111111
