111111111111
100000100001
140000000001
100000000101
101100200001
100000000101
100000000001
100011013001
100011000111
100000000001
100001000001
111111111111
