111111111111
100000000001
104000000001
100400000101
100000000001
100100300011
100000032001
100000000001
100000000001
100110000001
100010000001
111111111111
