111111111111
100000000001
144000000111
100000000001
100100000011
100300300001
100000020001
100000000101
110000100001
100000100011
100000000001
111111111111
