111111111111
100010000001
140000000401
100000300001
100000000001
100000000001
101000000201
100000100001
100030000101
100000000001
100000000001
111111111111
