111111111111
100000000401
100000000001
100000000001
104000000001
100003200401
100000030011
100000000001
100000003011
100000010001
100000001001
111111111111
