111111111111
100410000001
100000014041
110000030031
100030010001
100000000001
100000000001
100000020001
100014000001
100000003001
100000101001
111111111111
