111111111111
104000000001
100100000101
100000000101
100000001101
140000030001
100000002001
110300000001
100000000101
100000100001
100000000001
111111111111
