111111111111
104010000001
100000000001
100000000001
100000100101
100003200101
100000000001
114000030101
110000000001
100010000001
100000000001
111111111111
