111111111111
100010100001
140100000101
100000000101
140000000001
100000000001
100000030001
100030010001
100000020001
100000000001
100000000001
111111111111
