111111111111
140000110001
100000000011
100000000001
140030110001
110000300001
100020001011
100000100001
100000001001
100100000001
100000000001
111111111111
