111111111111
100000000001
100000000011
114000030011
100000000001
100000000001
104000000001
100000200101
100300000001
110000100001
100000000001
111111111111
