111111111111
110000000001
141001000401
100010000001
100000000001
100000330001
100002000001
100000110001
100000000101
100000000001
100000000001
111111111111
