111111111111
100300040401
100030100301
100000400001
100000000001
100000030001
103000010011
100000020011
101004030001
100001000401
104000000001
111111111111
