111111111111
100000004001
100403300001
100000300001
100100000001
100000000001
100000000201
103400000401
100000100001
100043000001
100000000001
111111111111
