111111111111
100000400011
140000000001
100000100101
100001000001
100320000101
100000000001
100000030001
100000000001
100000100001
100010000001
111111111111
