111111111111
100040000041
104000000101
103010000001
100000300001
144000000111
100000030001
100000203001
100300000001
110010001001
100000000001
111111111111
