111111111111
100000000001
101040010001
100001000001
100000210011
100430001001
100000000011
100030003001
100000000101
100000000001
100000000041
111111111111
