111111111111
100000000001
100001000001
104000000001
104000000011
100000300001
100010030001
100000100011
100000020001
100001000001
101000000001
111111111111
