111111111111
100000010001
141000000001
100000000001
101400000101
100003010011
100001320001
100000001001
100000000101
100010000101
100000000001
111111111111
