111111111111
100004000001
100000000301
100000300001
100000000301
100000030001
140000000001
103400040011
100400310001
100304020001
140000000001
111111111111
