111111111111
100000000011
104000100001
100000000001
100000000011
100010301001
110000030001
100100000001
100020000001
100000040101
100000011001
111111111111
