111111111111
104000110001
104000000001
100000000041
100001000111
100000330001
103002000001
100000100001
100010000001
100001110011
100001000001
111111111111
