111111111111
100000000101
110000000001
100000300001
104000000001
100000041001
100000002001
111000000001
100403300001
100000000001
110000000001
111111111111
