111111111111
140000000001
100000100001
100000000001
100000001001
100000343001
100002000001
100000000001
100000010001
100100000001
100100010001
111111111111
