111111111111
100000001001
140010000001
140000000001
100000000001
110000320001
100003000001
110000100001
100010110101
100000100001
100000000001
111111111111
