111111111111
100000110001
100400010001
140001001001
100010001011
100000020001
101003300101
101000100001
111000000001
101000000101
100000000001
111111111111
