111111111111
100000000111
104400000001
100000010001
101000000011
101300023001
100000000001
100000000011
100000000001
100010000001
100000000011
111111111111
