111111111111
101000000001
101010000001
101030000001
100440100011
100000100001
100000000001
100000200101
100000000001
110030001001
100000000001
111111111111
