111111111111
101000000001
100000030001
100000000001
104000000011
101001000001
104000300401
100013000001
100010001001
100000012001
100000000001
111111111111
