111111111111
100010000001
111000001001
110000000101
104040000001
102000030001
100000000001
100000000011
100300100001
100000000001
100100000001
111111111111
