111111111111
110000000001
100000000001
140000100001
100000000001
100001230001
100000340011
100000000001
100000000001
100000000001
100000000101
111111111111
