111111111111
100010000001
100000100001
140100000001
100120000001
101000130001
100001100111
100000011001
100000000011
100000000011
100000000001
111111111111
