111111111111
100000000011
100100100001
100000004001
110000200001
100000000001
100000401001
100000000001
100300030001
100000000001
101000001001
111111111111
