111111111111
100000001001
100000000001
110000301001
104000000001
100003020001
140030000001
100003000001
100000010001
100000040001
140000000001
111111111111
