111111111111
100000000001
100000000001
100000000001
100030000001
100010000001
100000430001
100000000001
100000011001
100000420001
100000000001
111111111111
