111111111111
100000000001
100400003001
100000001401
100000000001
100000030001
100000000001
100000010001
101000300001
100000020001
100040100001
111111111111
