111111111111
100000000001
100020000001
100000100001
100100001101
100000000001
111000000301
100000000301
100000400101
100000040001
100000000001
111111111111
