111111111111
100400000301
100000000001
100000100001
100001000001
100000000001
100010043001
100000403001
100000020001
100010000001
100000000001
111111111111
