111111111111
100000000001
100004000001
100010000001
100000100001
101000030101
100000000001
100001020001
100001030011
100000000001
100400000001
111111111111
