111111111111
100040000001
103100000001
100001000001
110040000001
140000000001
100000100001
100030003001
140003203001
100000000001
100000004001
111111111111
