111111111111
100100000001
100000000001
100030000001
140000000001
110000000001
100040030001
100000200001
100000000001
100100340001
100000000001
111111111111
