111111111111
100000000001
100000000001
101000040001
100030000001
100030000001
100000020101
100040030101
100000000041
100400000301
100000000001
111111111111
