111111111111
100000000001
100000000001
100040030001
100000000001
100040103001
100300000001
101000000041
100000020001
140000000031
100000000001
111111111111
