111111111111
100000010001
100400000001
100000000001
100003000001
100030000001
100100000201
100000000001
100403000001
100000000101
100000040001
111111111111
