111111111111
100000000001
100300000001
100003000001
100000000001
100000400101
100000000411
100000000011
110000001001
100000200001
100000000001
111111111111
