111111111111
100000100001
100000000001
100000000001
100000000001
100100300001
100000140101
100000020001
100010000001
110003004001
100000000001
111111111111
