111111111111
100000000001
100000114101
100000000001
100040000001
100112000001
100103304011
100000030001
100000000001
100000000001
100000000101
111111111111
