111111111111
100040040001
100000000001
100001000001
100000310001
100030000001
100000103001
100003300001
110040002001
140000001041
100000000001
111111111111
