111111111111
100000000001
100000000001
100000300001
100000000001
100110000001
100000000001
100000001041
100010302001
100000000001
104000000001
111111111111
