111111111111
100000000001
100000000001
100040010001
100400000001
100000000001
100000000001
100003100001
100030200001
100000010101
100000000001
111111111111
