111111111111
100000000001
100000300001
100000000001
100400000001
100040102011
100000010001
100000000001
100403003001
100100000001
100000000001
111111111111
