111111111111
100000000001
100000040001
100000020111
100000003001
100300110001
100000110001
100410001001
100010000001
100000000001
100100000001
111111111111
