111111111111
100001000001
100000300001
100000003001
100000030401
100000000001
100020000041
100000000001
143100000001
100001000041
100000000001
111111111111
