111111111111
100000040001
100000000001
101000000001
100041000001
100003030021
110000000001
100000431001
100001000001
101000000001
100000000001
111111111111
