111111111111
140000000001
100000000001
100000000001
100000000001
100003000101
110000300301
100000400001
100000020001
100040000001
100000000001
111111111111
