111111111111
100000010001
100000000001
100000000101
100002000001
100000400001
100000000001
100000003001
100003000001
100000000011
140000000001
111111111111
