111111111111
100000000001
100000010001
100100030001
100000000001
103010010001
110000101141
100003000001
100000001201
140001100001
100004000001
111111111111
