111111111111
100000040001
100010000001
100000001001
100004300001
100003010001
100000000001
100400000101
101000030011
100002000001
100000000001
111111111111
