111111111111
100000010001
100000000001
100301000001
100001000001
100000031001
100000000001
140000020001
100000000001
100004000001
100000000001
111111111111
