111111111111
110000000001
110001000001
100400000001
100000400001
110043000301
100000000001
100000000001
100023000001
100300000401
100000000001
111111111111
