111111111111
111000000001
100000000101
100000000001
100300000101
140000000001
100001004401
100000010201
100000003001
110000000301
100000000001
111111111111
