111111111111
100000000001
100000000001
100000000001
100000000001
102004010001
100000004001
100000001301
100100130011
100000000001
100100000001
111111111111
