111111111111
100010010001
100000000001
100000100001
100000010011
100020000001
100000000011
100300301001
101100000001
140000004001
100000000001
111111111111
