111111111111
100000000001
100000100001
100040000001
100000000001
100000000101
100000000041
100000230301
100000000001
100000000001
100000000001
111111111111
