111111111111
100010000001
100000000001
100000000001
100300000001
101100000011
100030000001
104000000001
100020000001
100000400011
100000000001
111111111111
