111111111111
100000000001
100000000101
100000400001
100000000001
100040020001
113000000001
110000000001
100003000001
100000000101
100000000001
111111111111
