111111111111
100000000001
100000000101
100000000011
100000030001
100000000001
100000002001
100000000001
104000030001
100000000041
100000000001
111111111111
