111111111111
100000000001
100000000001
100000010001
100000000401
100000300001
100000300001
100000000001
100000020001
101001001001
100004000001
111111111111
