111111111111
100010000041
101000400001
100300000001
100000000001
110400000001
100000000301
113000010001
100000200001
100040103001
110000000001
111111111111
