111111111111
100000000001
100000100001
100000010001
100000011001
100000000001
110030020001
100000000001
100003010001
100000004001
100000400001
111111111111
