111111111111
100000000001
100410100001
100040000001
100003000001
100000010001
100000320001
100004003001
100000001011
101000000001
101001000001
111111111111
