111111111111
100000000001
100000000001
100010000001
103300000001
100000040001
100000004001
103000012001
100000000001
140000030001
104304000001
111111111111
