111111111111
100000000001
100000000001
100010000001
100000000001
110000004001
100003000011
100000102001
100000030001
100000010001
100000410001
111111111111
