111111111111
100000001001
100001000001
110030001001
100400000001
100000000001
100040200001
110100130001
100000030001
110041000001
110100100001
111111111111
