111111111111
100000000001
100000000001
100000000001
104000000001
100000000001
100000001401
110000200001
100000330001
100000000001
100000000001
111111111111
