111111111111
100000000011
100000000001
141000000001
100040002001
100000000101
100333000001
100000301101
104000003001
101004000001
100000400001
111111111111
