111111111111
110000000001
100000000001
100030000001
100000010001
100010004001
100120130011
100000001001
100000000011
100000100001
100000000401
111111111111
