111111111111
100000000001
100000000001
100000000001
100000000001
110000000001
104023010001
104000010001
100004300001
100000030001
100000000001
111111111111
