111111111111
100000000001
100000000001
100000000001
100000300001
100000000001
100000000401
100001100201
100000000001
100011003001
140000000001
111111111111
