111111111111
100000000001
100000000001
100400000001
100003013001
100000000001
100000000001
101100201001
100003040001
100000004001
100100000001
111111111111
