111111111111
100000100001
100000010001
100000030001
100000000001
100100000001
100000002001
100003003001
100400400001
100000000001
110000000401
111111111111
