111111111111
140000000001
100000000001
100000000001
100000001001
100000010001
100320100001
100000000001
100300000001
104000000101
100000000001
111111111111
