111111111111
101000000001
100000000001
100000000001
100000100101
100000030001
100020000001
103000010001
100000000001
100004000001
100004000001
111111111111
