111111111111
100000000001
110000000001
100040000001
100100000001
100000300001
100000301011
100000000001
100000010001
100000200001
104010000001
111111111111
