111111111111
100000000011
100000010001
100000010001
101111001001
100400020001
100000030001
100400000001
100010030001
100001000001
100000000001
111111111111
