111111111111
100000000001
100000000001
100004000001
100000300001
100400000001
100000000001
100100200001
100001301001
100000010001
100000000001
111111111111
