111111111111
100000000001
100000001001
101000010001
100000200001
100030000001
100110004001
100100000001
100000030001
100000000001
100040000001
111111111111
