111111111111
100000000001
101000000001
100000010001
100000000001
100000300001
100000300001
100300100001
100000010001
100200044001
141000000001
111111111111
