111111111111
100000010001
100000000001
100040000001
100000000001
100100300001
100000010011
100000021101
100000300001
100140000001
100000000001
111111111111
