111111111111
101000000001
100000000001
100000100001
101000000001
100000000011
100310004011
100003000001
100032100001
100400000001
100040000001
111111111111
