111111111111
100000400001
100000000001
101000100001
100330020001
140030000301
100000100001
104030410001
100040000031
100000000041
100100000001
111111111111
