111111111111
104000000001
100001000001
100003300001
100000000001
100000000001
100000001001
102100000001
100000004001
103000000001
100040000001
111111111111
