111111111111
100000000001
100000000001
100000000001
100000000001
100400000001
100000100001
100003301001
100000300101
100000020001
100440000001
111111111111
