111111111111
140000000001
100000000001
100100000001
100001004011
100300000001
100000000001
104000300001
100002000011
100003010001
100000000001
111111111111
