111111111111
100000000001
100000000001
100004000001
100000000001
110030300001
100000003001
100000020001
100000000001
100000011001
100004001041
111111111111
