111111111111
100001000001
100000000001
100000000001
100000001001
100000230001
100000000001
110003000011
100000010001
100000000001
100440000001
111111111111
