111111111111
100000000041
100000001001
100000000001
100010010001
100100300001
101200300401
100100000001
100000100001
100000000001
100000000001
111111111111
