111111111111
100000000001
100000000001
100000300001
100000000001
110000040101
100200000011
104031000001
101000000001
100010000101
100010000001
111111111111
