111111111111
100000000001
101003011001
103011011001
100000400001
110210040141
100010310001
100100010001
100100010001
110000000001
110100100111
111111111111
