111111111111
100001110001
100001113101
101000000001
101001110001
100004100101
111101100101
111100002001
111100111101
111000000001
111000010001
111111111111
