111111111111
110000000001
100011010001
101111301101
100010001001
101003104001
100140000011
100101001001
104000001001
100311211001
110000000011
111111111111
