111111111111
101110000001
101010000101
100003111101
101314001001
100011100001
104000001101
100001002001
110110101001
110000001101
111110011001
111111111111
