111111111111
100000000001
100003000001
100001030001
140000000001
100000040011
100002300001
100000000001
100000000001
100000040101
100000000001
111111111111
