111111111111
100000000001
100000010001
103000443001
110000004001
100000001011
100000210001
100000000001
101000000001
100010300011
100010010001
111111111111
