111111111111
100000000001
100004000001
100101340001
100001003001
100001201001
100000000001
100000100001
100000000001
100001000001
100000000001
111111111111
