111111111111
100000100001
100000000001
100100431001
110010000001
100120000001
100000100001
100000000001
100000000001
100000000001
101000000001
111111111111
