111111111111
100000000001
120130000001
104000000001
100003003001
100000100001
100000010001
100000000141
100000010001
100000400001
100000000001
111111111111
