111111111111
100100000011
100000040001
100000001001
100000100001
110002300001
100000000001
100001000101
110001000001
100001001001
100000100001
111111111111
