111111111111
100000000001
100000000101
100000410101
100000000001
110100340001
100001300001
100000200001
100000000001
100001000001
100000000101
111111111111
