111111111111
100000000001
100000100101
100004043001
101000013001
100010000001
100000000011
100100021001
100010000001
100000100001
100000000001
111111111111
