111111111111
100000000001
100000100001
101001000001
100000000001
100002000301
100000400001
101000010001
100001000001
100001000001
100000000001
111111111111
