111111111111
100110000001
100040010001
101000400001
100100010011
103000200001
110000000001
100000000001
100000030001
100111000101
100000000001
111111111111
