111111111111
100000100001
100101000101
100001040001
100000300001
100002000001
100000010101
100010000001
101000001001
100011000001
100000000001
111111111111
