111111111111
100000000001
100001000001
100001040001
100000341001
100000000001
100023000001
100000000001
100010000001
100000010001
100100000001
111111111111
