111111111111
100400300001
100000000001
103000100001
100000000001
100300003041
100000000041
114000000001
100000000101
100002001001
100000000001
111111111111
