111111111111
140000001001
100400000001
100000000001
101100300001
100030200001
110000030001
110000010001
101100000001
100000000011
140000100001
111111111111
