111111111111
100100000001
110000000101
110001040001
100000300001
100020100001
100000001001
101001000001
100000000001
100000001001
100000010001
111111111111
