111111111111
110000000001
104000000101
100000000001
100001003011
100200001011
100000001001
100000000101
100030000101
110000000001
100000000401
111111111111
