111111111111
100000000001
100000000001
100000040301
100010000001
100030404001
100010000301
100000200101
100000010001
100000000001
100000000001
111111111111
