111111111111
100000000001
100004430001
100000010001
103001430001
113000003041
100003200001
101000040001
100011000001
100010300001
100010440001
111111111111
