111111111111
100000000001
100000400001
100000000111
110034010001
100100023001
100000010001
101000000001
100000000001
101000000001
101000000001
111111111111
