111111111111
110010000001
100000000001
100300004001
100000004301
100000201001
100000000001
110001000001
100100000001
100000000001
100001000001
111111111111
