111111111111
100000000001
100000003001
100030000001
100000110001
141000004001
130000040001
100003000001
100000004031
101020103041
100004000001
111111111111
