111111111111
100001100001
100010000001
100000443001
100000000001
100000200001
100000300001
101000010001
100001001001
100000000001
101000000001
111111111111
