111111111111
100000000001
100000000111
100000030001
100000040001
100000000001
100000200001
100001000001
100001000101
100000100001
100000010011
111111111111
