111111111111
100004044001
100000000001
100000000001
100003003001
100000003001
100040003011
100200010101
100000000001
100100000001
100000000001
111111111111
