111111111111
104000000401
100000001101
100000000001
110001010001
100002000011
100000030011
100000000001
100000030011
100000110001
100000000001
111111111111
