111111111111
101000010001
100000104001
103004000301
100000030001
100000010001
100002140001
100040001101
100000000001
100010030001
100001000001
111111111111
