111111111111
100101100001
100000110001
100000400001
100000010001
100000310001
100100000001
100002000101
101000000101
100000111001
100000000001
111111111111
