111111111111
140000000101
100400000001
100211003001
100000004001
100000000301
110000030001
100000100001
100000000001
100000000101
100100000001
111111111111
