111111111111
100000000001
140001000041
100001003001
100100210001
100000000001
100001000011
100000010001
100013000001
100000010001
100000000001
111111111111
