111111111111
100000000101
100104110001
100100000001
100110043001
100002000001
100000301001
100000010001
100100000001
100000000001
100100000001
111111111111
