111111111111
100000000001
100004030001
100430003001
104010040001
100000000011
100001200001
100043000001
100010000001
100000013001
100000000001
111111111111
