111111111111
100000000001
100000003001
100000013401
100010400001
100002400001
100000000001
100000000101
100000001001
100300000001
100000110001
111111111111
