111111111111
110000000001
100141000041
100020000001
100000440001
103000100001
103000030001
100000040001
100000000001
100300003001
100001000001
111111111111
