111111111111
104300010001
100000400011
103000004101
100000000001
100000000001
100030001001
110000200141
100000000301
100001000001
100000000001
111111111111
