111111111111
100000000001
100403100001
100000000001
100000100401
100000203001
100000000001
110300000001
140000000001
100000000001
100000000001
111111111111
