111111111111
104000040001
100000100001
100000000001
101040000001
100030000001
110000000001
100200000001
100000300301
100010000001
100000010001
111111111111
