111111111111
140000030111
140000000301
100000000101
100000000001
100200010001
101003010001
101000000001
100000000001
100000400001
100000000001
111111111111
