111111111111
140000000401
100010100001
101000300141
110100030001
110000100001
100000100001
100000201001
100001000011
100000003011
100000000001
111111111111
