111111111111
110000000001
100000000201
100030030101
100000104011
101000040001
100000000001
100000000001
101001000001
130000001001
140000000001
111111111111
