111111111111
100000000001
100000100011
100000400001
100030000001
103000204001
100000000001
100011000001
110000000001
100000100101
100400030001
111111111111
