111111111111
100010000011
100001100001
100000010101
110043010111
100100000001
104000330101
100000010001
101400000001
100021000001
100000000011
111111111111
