111111111111
100000000011
100000000001
100000300001
101100001001
111002401001
100004130301
100000001001
100010001011
100010000001
101000010401
111111111111
