111111111111
100000000001
100000100001
100330000001
100200040301
100004000001
100000400001
100000000001
100000000001
100010000101
110100000001
111111111111
