111111111111
100000000011
100100003011
100000000001
100014110001
100042000001
100404000011
103301300011
100100001001
100000100001
100000000001
111111111111
