111111111111
110000000001
110000400001
100033300101
100020000001
100010000401
140003400001
100000400001
100000000001
100030000011
100000000001
111111111111
