111111111111
100000000001
100000000001
100000000001
100030000001
100010300011
100324400001
100304410001
100000000001
100000000001
100000000001
111111111111
