111111111111
100000000101
110003000001
100003000001
100000140001
140000230001
100110310401
101000000001
100000000011
141000000001
100000000001
111111111111
