111111111111
100000000011
100100000001
104000200001
100003000011
100003310101
100000004001
100000100001
101001004001
100000000001
100001000001
111111111111
