111111111111
101000040001
104000001101
100000010001
100000010101
100030200111
111000010001
103000000301
100001010101
100000000001
100040101001
111111111111
