111111111111
100000100001
100000000001
104400300001
100010000001
100000000001
100001303001
100000000121
100000104001
101000000001
100000110101
111111111111
