111111111111
100100100111
100030000001
100003000001
110001000101
104102001101
100001304011
100400001001
100001000001
100000000001
100000100001
111111111111
