111111111111
100000001001
100110100001
100100000001
100000003001
110010010001
104000000011
140100010021
100001300001
100000000101
110000000001
111111111111
