111111111111
101000000001
100101001011
110000000111
104000040001
100013000001
100002300011
100131010101
100000000041
100000000001
100000000011
111111111111
