111111111111
100100001401
101000000001
100000300001
101103000001
100000000001
100000400001
100032400001
100000000001
100000000001
100000010001
111111111111
