111111111111
100000010001
100000000001
100000000001
100030010001
140330010001
100000000001
100020401111
100000400011
100000000001
100000000001
111111111111
