111111111111
100010000001
100400000041
100000010001
100030301101
110000300001
100000041001
100000200101
100004000001
100001000301
100000000001
111111111111
