111111111111
100000000001
100000300001
100000300001
100411001001
100010400001
101004200001
100003400011
100030000001
100000000001
100000000001
111111111111
