111111111111
100000000001
100101140001
110100000001
100000000001
101003000001
110003320401
100000101001
100000000001
104010000001
100000000001
111111111111
