111111111111
100000000011
100011000001
100000000001
100000000101
100003301001
100134124001
100000100001
100000400101
100000000001
100000000001
111111111111
