111111111111
100000000001
104000004001
100000000001
100003000101
141000300001
110003300101
100012000401
100000100001
100000000001
100000000001
111111111111
