111111111111
100000000001
100001100041
100000000001
100010400001
103000300001
104412300011
100000300001
100000011011
100000000011
100000001001
111111111111
