111111111111
101000000001
100100001101
104000000101
101000000001
100000300001
103310041001
100030200001
140000000001
100000140001
100000000001
111111111111
