111111111111
100101000001
103000010001
101000010011
100000004001
100100000001
100023400301
101000400001
100000000001
101001000001
100001000001
111111111111
