111111111111
110001000001
100000011011
140300000001
110000000001
100000000001
110100300001
140000000011
100000000001
130004201301
100110410001
111111111111
