111111111111
101000010011
100303004001
100000000001
101000000101
100000310001
110002030401
100100000011
100000001001
100001100041
100000000041
111111111111
