111111111111
110000000001
100000400001
100004001001
100000000001
140010010001
100033240001
100330011001
100000000011
100000000001
100000000001
111111111111
