111111111111
100000000041
100000010101
100000000001
100040030001
100001010001
100002330101
100030404001
100000000001
100000000001
100000000001
111111111111
