111111111111
100000000001
100000101101
100001010001
100000300101
100000030001
140100200001
100131400101
100000000041
100000000001
100000000001
111111111111
