111111111111
100000000001
100000000001
100404001001
100000000041
101001001001
110003030001
100001300001
101100300001
102000004001
101000000101
111111111111
