111111111111
110000000001
101030000101
100100400001
100000100001
140000000001
100000400001
101002100301
100030010001
100000000001
100000000011
111111111111
