111111111111
101010000001
100030010001
111000000041
104000010011
100000000011
100000230001
100000400011
100000310001
100010000001
100000000001
111111111111
