111111111111
100000000411
100000000001
104001000001
101010000001
100000000001
100000330001
101000000111
103000000001
100011000201
101100040011
111111111111
