111111111111
100000000001
100100000001
100103300101
100000400001
101000011001
100210030001
100000000001
100000000001
104000000101
100004000101
111111111111
