111111111111
100000000001
100100000001
100001300001
101000000001
100000400101
103404403001
103012000001
100000010001
100000000001
100000001001
111111111111
