111111111111
100000001001
110400000001
100100000011
100000030001
100002013001
100000300001
100000000001
100040000001
100000000001
101100000041
111111111111
