111111111111
101100000001
100000000001
100000030401
100000000101
100000040001
104100200001
100003000001
100000310001
100000000001
100000000001
111111111111
