111111111111
111121000001
140000000001
101000000041
100000300001
110000000001
100033300001
100001010001
100000400011
101001000001
100000040001
111111111111
