111111111111
100000000001
110000000001
101000400001
100000000001
100000011001
140133340101
103200400101
100000000001
100000000001
100000000001
111111111111
