111111111111
100101000001
100100011001
100000000101
100000000001
100010000001
103033010001
100002400411
100400000001
101000000001
100000000101
111111111111
