111111111111
104400004001
100300100011
100000000001
100000000001
100003300001
101032000011
101000100001
100000401111
100000000101
100000000001
111111111111
