111111111111
100000000001
100000000001
140001011001
100004000001
100002100101
100030304001
100003000001
100000010001
100000000001
100000000001
111111111111
