111111111111
100000000001
100000000001
104000000001
100003110001
100002000101
100000330001
100030044001
100010010001
100000400001
100000000001
111111111111
