111111111111
100000000001
100000001001
100000001101
101001303001
140000040001
100130114001
100002000001
100000001401
100300000001
110000001111
111111111111
