111111111111
110040000001
103000000001
100000040001
100010100001
111000100041
100013230001
100110000001
100010000001
110001000001
100100000001
111111111111
