111111111111
100000000001
104000000001
100000001001
100000110001
100030210001
103330440001
100010400001
100000000001
100000000001
100000000001
111111111111
