111111111111
110000000001
100000000001
100040130001
100000101001
100000101001
140133200001
101000400001
100000000101
100100011001
100000000001
111111111111
