111111111111
100100000001
110000000001
101011000001
103012410001
100001000001
100100310001
110000400011
100001000001
100000000001
101001100011
111111111111
