111111111111
100001000001
100001000011
100000400101
100000000001
100300100001
100000300001
100204300001
100000000001
100000000001
100000000041
111111111111
