111111111111
100000010001
100040100001
100000010001
100100400001
100000010301
101001000001
103000200001
100011000001
100010000001
110000110001
111111111111
