111111111111
110001104011
100400300001
101000000001
100000000001
100100100001
100120303001
101001001001
100000100001
100014000001
100000000001
111111111111
