111111111111
100000000001
100000000111
100003000001
100000040011
100030000101
111024000001
100003040001
101030000001
100000104001
100000000001
111111111111
