111111111111
100000000001
101000000001
100000000001
101031000001
100004000001
103042401001
100030001001
100000000001
100000001001
100000000001
111111111111
