111111111111
100000000001
110000000001
100000100001
100012000041
100040010001
100003303001
100000300001
100000000001
100010000001
140000100041
111111111111
