111111111111
101000400011
100400000001
101000000101
100030001001
100000003001
100003301001
101020400001
100010000001
100000004001
100000000001
111111111111
