111111111111
100000000101
100001100001
100000000401
100000301001
100000300001
140310010001
100013244001
100000000001
100000000001
100000000001
111111111111
