111111111111
100004000001
100140301101
110000300001
100000100001
100300000001
100302000001
110000404001
100000000001
100000110001
100000000001
111111111111
