111111111111
100000000011
100000000001
140100000001
100000000001
101000301001
100310300001
103002400001
100000400001
100004000001
100000000001
111111111111
