111111111111
100000000001
100000000001
100001300041
100000300041
100011040001
143002000001
101000300001
100000000001
100000000101
100000000001
111111111111
