111111111111
111030004011
100000000001
140000010001
100000040001
100000121001
100110300101
111000010001
100000030001
100000000001
100001000001
111111111111
