111111111111
100010000001
100003000001
100000000001
100030200001
101040040001
140000001001
100000000001
100100300001
101100000001
100000000101
111111111111
