111111111111
100000000001
100000000001
101000000001
140010040001
100040030001
103302134001
100003040001
100000000101
100000000001
101000010001
111111111111
