111111111111
100100000001
100000000001
100000300001
100003100001
100002000001
104031400001
100000410101
100010000001
100000000001
100000000001
111111111111
