111111111111
100001000101
100001300001
140000000001
100100140001
100001010001
100000000041
100002130001
100000300011
100000000101
100000000001
111111111111
