111111111111
100000000001
100000100001
110000000001
100010310011
100004010001
100032300001
100030400001
100000104001
100000000001
100000041011
111111111111
