111111111111
111000000001
100000000001
100000010101
100003000101
100000014001
140012301001
100100000011
100000001001
100000000101
100000000001
111111111111
