111111111111
100010000001
141000000001
100000000001
100230030001
100001010001
101100400301
100004110001
100000001101
100000000101
100000000001
111111111111
