111111111111
101110000001
100000000001
100000000001
104000001001
100000303001
100000300001
100030211001
100411001001
144010000001
100100000001
111111111111
