111111111111
100100000001
100010300001
100010010001
104000000011
101000100011
100000000001
100030000001
110040000001
101013000011
100000040021
111111111111
