111111111111
100000000001
100000010041
100031200001
100003000401
100003000001
100004330001
100000440001
100000000001
101010000001
100000000001
111111111111
