111111111111
100000000001
100300000001
100001100001
101000100001
100000340001
100301440101
100100010001
100000000001
100000200001
100000000001
111111111111
