111111111111
100000000001
100100000001
100000400001
104000000001
100100201001
100000010001
103010330101
100000000001
100000000001
100000140001
111111111111
