111111111111
101000000001
100000300001
103000010001
100000400001
100000001001
100002400001
100000430011
100100000001
100000010001
100000000001
111111111111
