1111111111
1000000001
1000003001
1000000001
1000200001
1000000001
1040000001
1000000001
1000000001
1111111111

