1111111111
1000000001
1040000301
1000000001
1030000401
1000020001
1000000001
1000000001
1000000001
1111111111

