111111111111
110100000001
110100031111
100000100001
101110101001
100040131101
101440000001
100010130011
100010000111
101000100011
101111121011
111111111111
