111111111111
111101110111
111000000011
111010000011
111030011111
110140440001
100001113301
100001110001
101000110001
100001111211
111001111111
111111111111
