111111111111
111000000011
100004401001
101111030011
100000010101
101111000101
100030301101
100400001001
100000030201
104011110011
110011100011
111111111111
