111111111111
101110001001
101100100011
100000001011
100400101211
101110100001
101100111001
100000001011
100010301001
101100111011
100000000011
111111111111
