111111111111
100000000101
101000400001
100003000101
101011003001
100000041001
100010000301
100020111001
101010140001
100000101101
100000000001
111111111111
