111111111111
104000000011
100000000001
100110110001
100040300001
100000100101
101010100001
100000040101
100001203001
101001003001
111001110001
111111111111
