111111111111
110000001111
100010000001
100120101301
100000101001
100001100001
104010004111
100300100011
100010000111
110101010011
100000000001
111111111111
