111111111111
100000000001
100000000041
100013300001
101000000001
100001110001
100441000001
100000020001
100030000001
100000000011
100000000001
111111111111
