111111111111
100001100001
100001000001
101000000401
100000000101
110010001001
110000111001
100300100001
100000002001
100000010001
100001000001
111111111111
