111111111111
100000004001
100000300001
100000000001
100100000101
100010420001
100010000001
100030000001
100010110101
100000000001
100000000011
111111111111
