111111111111
100004000001
100000000001
100000000301
100000300001
100300030001
100000240111
100000410001
100000100011
100000400001
100000000001
111111111111
