111111111111
100000000011
100000300001
100010000001
100000000001
100000010001
100400240001
100010100001
100000003001
100000000001
100000010011
111111111111
