111111111111
100000000001
110010000001
100000103301
100000010001
100000004001
101000020001
100000440001
100010000001
100003000001
100000000011
111111111111
