111111111111
110000000001
110000010011
100000010001
140000100001
100000000001
100003300111
104020000001
100000000001
110010000001
100010001001
111111111111
