111111111111
100010000001
100000040001
100004001001
100000000001
100000003001
100010040301
100000023001
100300000001
100040000001
100000000001
111111111111
