111111111111
100040000041
100000003401
100000000001
100000000031
101001030001
100300300001
140002000001
100010000401
100000000011
101000000111
111111111111
