111111111111
100000000001
100000000001
100000100001
100000230001
100000300001
100004103001
101000000001
110000000011
140000000041
100100101011
111111111111
