111111111111
100000000001
100001000001
100010010001
100010011011
100103100001
100110200001
100400000001
100100000011
100000001011
100000000001
111111111111
