111111111111
110010000001
100000100201
104110000011
100000000001
100110030101
100001000001
100000300001
100000000001
100010400001
101000000011
111111111111
