111111111111
100000000001
101000000101
101011010001
101000000001
101004000001
100100000001
103000000011
100000003101
100100000241
100000000001
111111111111
