111111111111
101001000001
100000000001
100011100001
100003000001
100000000001
100000021001
100040000001
111000000001
100000100001
100010000001
111111111111
