111111111111
104000000001
101000000001
100000000001
100000000001
100100300001
100040303041
100000300001
110000000011
100011000001
101002000041
111111111111
