111111111111
100000000001
100000100101
100001000011
110000000001
100000320001
101000430001
100400000011
100000110001
100010000001
100000000001
111111111111
