111111111111
100000400001
100000000001
100000000201
100000030001
100000003001
100001010011
100001000011
100000000001
100000000001
100000100401
111111111111
