111111111111
100000000001
100000300041
100110000001
100000000011
100000010011
100114000001
100000030001
110102000001
100000000001
100000000001
111111111111
