111111111111
100000000001
110000000101
100003010011
101001002001
110100000001
100003040001
110000014001
100000010001
100000000001
100000000001
111111111111
