111111111111
100000000011
110000000001
100000100001
100000323001
100000000001
100000040001
100000000001
100000040001
100000000001
100000000001
111111111111
