111111111111
100400100001
102000000001
100000101001
100010101001
100100003401
140000000301
100001000011
133000001001
100001004001
100000000001
111111111111
