111111111111
100000000001
110401001111
100000000011
100000300001
100000210001
100000304001
100000100001
100100100001
101000000001
100000000101
111111111111
