111111111111
100000000001
100000000001
100000400001
100040000001
100000000001
100000333011
100000302041
101001030001
100001000001
100044000001
111111111111
