111111111111
111000000001
100000000001
100100000001
100010001001
100310000201
140000000001
100001010001
100000001111
100000000001
110100000001
111111111111
