111111111111
110000010001
100100000001
110031100001
100003000101
101000000201
100010004001
100000000401
100000000111
100010000001
100000000011
111111111111
