111111111111
100000000001
100000000001
100000400001
100100000001
100000230001
130041000001
100000300001
100000100101
100000100001
140000000001
111111111111
