111111111111
100000000001
143120000031
100400010001
100000000101
103000000001
100040010001
100001000001
100000000041
100003000001
100000000001
111111111111
