111111111111
100000000001
100400000001
100000000201
100010300101
110100310101
100000003001
100000000001
100000404001
101000000001
100000000001
111111111111
