111111111111
100400110001
100000000001
101000000141
100101010011
100000300441
101403331011
100000320001
100001300401
100000000001
100010000001
111111111111
