111111111111
100000000001
100000000101
100010000011
100000200001
100110000001
100004000001
101000010301
101100000001
100000000001
100000000001
111111111111
