111111111111
110000000001
100000000001
100010100001
100000001001
100134020001
101000000001
103000000101
100000000001
100000140011
100000000001
111111111111
