111111111111
100001000001
100401000001
100001000001
100130000111
110030000001
100000320101
100000040001
100010010011
100000000041
100000000001
111111111111
