111111111111
100011000001
101000000101
100000004001
100000300001
100010001101
100400200001
100030010001
100100100001
100000010011
100000000001
111111111111
