111111111111
100000000011
100003000011
100010000001
100000020101
100001000011
100010040001
100000000001
100000100011
100000110001
100001000001
111111111111
