111111111111
100011000101
101000000001
100000440001
100000000001
101100010401
100000300001
100100203011
100100300311
100100000001
100001400001
111111111111
