111111111111
100000110001
104000000001
113000001001
100100010001
100003000001
100004000301
101000001001
100004000001
100000000101
100000200001
111111111111
