111111111111
100000000001
100001400041
110000001101
101000000001
100000001001
100032010001
100000010001
101000000001
100010031001
100000000001
111111111111
