111111111111
100000000001
101004100001
100001000001
100000030101
100000340001
100000010011
100000000001
100200000001
100001001001
100000000101
111111111111
