111111111111
100010000101
110000000001
140000000001
100000000001
103000000101
100003200101
100000100011
101000000001
100000000001
104000000001
111111111111
