111111111111
100000000001
100100001001
100001400001
100020000101
100000001001
140140003001
130110000001
100401300001
100000030001
101000011001
111111111111
