111111111111
100000000001
101030000001
101040000001
100000300001
100000040301
101114002001
100000000101
100000000011
100000000001
100000100001
111111111111
