111111111111
100100000001
100000300001
100000100001
104000000001
100000301001
101000042401
101103010001
100000000101
110000000001
110010000001
111111111111
