111111111111
101000010001
100000000001
100003000001
100100000001
100000000001
100000000011
140000000001
100000002301
100000100041
100000000001
111111111111
