111111111111
100000000001
100000400001
100000000001
111030000001
100003030011
100100002001
100001010001
100000040001
100100040001
100000000001
111111111111
