111111111111
100000000001
100000300001
100000003011
100010010001
110000400001
100000400001
100000000001
100000210001
100000000001
100000000001
111111111111
