111111111111
100001000401
100011000011
100000110401
100100000101
100103000001
100000023001
100100000001
100000003041
100000000001
100101000011
111111111111
