111111111111
110010001011
100000100001
140000001001
100000000301
110000300001
100001420001
100000000001
100101001101
101000110011
100000000001
111111111111
