111111111111
100000100001
130000000301
100000100001
100000100001
100000000001
140003040411
100100000001
100000010001
110010000001
102000000001
111111111111
