111111111111
100010001001
101041100011
102000300001
100000000411
100033010001
100000000001
100004004011
103000011001
100000000101
100000000001
111111111111
