111111111111
100000000001
100000000101
100000140001
100010000001
100000300001
100030240101
100000000011
100000000101
100010000001
100000000011
111111111111
