111111111111
100000000001
100040001001
100004011001
100003000001
100330000001
100000001001
100000000101
110000002401
100000000001
111000000001
111111111111
