111111111111
100000000001
100000000001
100000000001
101000100301
100000000001
100300110001
100000000001
101000040001
100000020001
100400010001
111111111111
