111111111111
100000000001
100001000011
100030004001
110000000001
110000031011
100000230001
110010000001
104000001011
100000000001
111000000401
111111111111
