111111111111
100000000001
110000000001
101003330001
140000300001
100000000001
100040201401
110000400001
101100000011
100100000001
100000000001
111111111111
