111111111111
100000004001
110000040011
100000030001
100400010001
100000033001
110000200001
100000340001
100100000001
100000000001
100000000011
111111111111
