111111111111
100400000001
111000000001
100011000001
103010001001
100010000001
100110003001
100000003001
100000042001
100101010401
100000000001
111111111111
