111111111111
100000000001
100000000011
100000410311
110001100001
100000000001
100400020001
101300000001
100000000111
110000000001
100000010011
111111111111
