111111111111
100100001001
100010000011
101300001001
100000000001
100100110001
110001100201
100000000001
100011040011
100010000001
100000000001
111111111111
