111111111111
100010001001
100010000041
101000000401
100000000301
100000100101
100001000001
100000010301
101000000101
100000011011
100021000001
111111111111
