111111111111
100000000001
100000000001
114000000001
101011000001
100000330001
100000102001
110000000001
110004000001
100000000001
100100000001
111111111111
