111111111111
101100100111
100001100001
100000010001
100300010001
100000001001
100000200011
100000001101
100000000001
100000400101
100000000001
111111111111
