111111111111
100000000001
100014000141
101400000001
110000030001
100000103001
101230103001
100000400001
100001000001
100000000001
100000000001
111111111111
