111111111111
110100000001
100000001001
101100100001
110000001001
110001140001
100000000401
101003300001
100000200001
110000010001
100010000001
111111111111
