111111111111
100100000001
100010000001
100000040001
100010030001
140100100101
100030001001
100000000011
100100000101
110000000001
100001200001
111111111111
