111111111111
100041000001
100100000011
100300004001
110000111001
111001000111
101000002101
103001000401
100000103001
100000000001
100000010001
111111111111
