111111111111
100000000101
100004000001
110000000001
100000002001
101303000401
100000400001
100103100011
100000110101
100100000101
100000000001
111111111111
