111111111111
110000000001
100300010001
100001102001
101003003011
100000000041
101110000101
140001000001
100100010001
100000010001
100000040001
111111111111
