111111111111
100000010001
100000000001
111000000001
100000010001
101000000011
100101300001
100033200001
100000004001
104410101001
110100000001
111111111111
