111111111111
100000000001
100001010001
100004100101
101000000001
100030110011
100004012011
100000000001
100000010001
100000003001
100000000001
111111111111
