111111111111
100000000001
100001000001
100001010001
144104000001
100000304001
100330100001
100002300001
101000000001
100001000001
100011010001
111111111111
