111111111111
100100000001
110010001001
100000000001
110000003001
100000000001
100040030401
100300001001
100000002401
110000000111
100000000011
111111111111
