111111111111
110000000001
100400000001
100000001101
101000100011
100000401001
100000333011
100010230001
100000000001
100000001001
100400000041
111111111111
