111111111111
110000000011
100000000001
100000200001
100000000011
100400000001
100000000001
100000300001
100100010001
100000000001
101000000001
111111111111
