111111111111
100440100001
100003000001
100000011001
100000100001
100100000101
100100320001
104010003001
100000340001
100000000001
100000000001
111111111111
