111111111111
100020000001
100040000001
101040000001
100100040001
100000000041
140030330111
130000300001
100000001001
100003000001
100400000001
111111111111
