111111111111
111011011011
100011000001
111011011001
111010200011
100011100041
100000000011
110101113011
110100000001
110101100101
100001110111
111111111111
