111111111111
101110111001
101100111001
100000000001
110011001101
100020000101
111013030001
100010401101
100010000001
110010010101
111000000041
111111111111
