111111111111
100000000011
101101101011
101001100011
101111010011
101110001001
100000000111
100101010001
110110002001
100003001011
111011041011
111111111111
