111111111111
100020110401
100100010001
100001010001
100100000001
100100010001
100000111001
100103100001
100000001011
100110100001
100000000001
111111111111
