111111111111
110001111001
100000000001
110111003001
100201001001
100001101001
110111100001
100001010101
100000000101
100001100101
101400000001
111111111111
