111111111111
100000000001
100000010001
101101011001
101121000001
100101410001
100000010001
101100311001
100000011001
100000000001
110111011101
111111111111
