111111111111
100000000001
100000000001
100011011101
100011111101
100010111201
100000100001
100140000001
100001003001
100100101001
100000000001
111111111111
