111111111111
100000021111
101111010011
101111000001
101101110001
100000000101
101111013101
101100010101
101110400001
100000001101
101101100001
111111111111
