111111111111
101100000111
100000010011
110011010001
110011010011
110111011011
110101001011
110000301001
100120000001
100100004011
100001110001
111111111111
