111111111111
100000000001
110001100001
110101113301
110000010041
100101111401
110100000001
111111010001
110011010011
110000020011
100000010011
111111111111
