111111111111
100000100101
110010110001
110112000001
110110100111
100103000111
101101110111
140000000011
100000110011
101010110011
100011111011
111111111111
