111111111111
111000101001
100000100001
101100101011
101002131001
100013101001
141014101101
100000000001
100000100101
101111110101
100000000001
111111111111
