111111111111
100000000001
100011101101
110102000001
140103001101
100101111101
100000001101
100011100001
110010000101
110010010001
100010010011
111111111111
