111111111111
100001111011
100000000001
100111011041
100111000001
100100001101
102111101101
101110000001
100010101101
101000000301
111011110001
111111111111
