111111111111
110000100001
100000001101
100111101101
101000031101
101020101001
111401000001
111000000101
111000101101
111110001101
111110100001
111111111111
