111111111111
100110100001
110100000101
140001101101
100011002101
100111010101
103000010101
100100110001
100110000011
100100111011
111111111001
111111111111
