111111111111
110040010001
110200000011
113011110111
110001110101
110301000001
100004010101
101110000101
100000110101
111100100101
111100110111
111111111111
