111111111111
101110100001
100020004401
100000300001
101011110001
101000110011
100000111001
110011003011
100000000001
110011010111
110000000111
111111111111
