111111111111
100000000001
111001011001
110030423001
110001101101
111000100101
101011101101
101400000001
101000001001
100011001001
100011001001
111111111111
