111111111111
111100000001
110003111101
100100200001
100103011101
100111011101
110400044041
100003030001
101013411101
101000430001
100000000111
111111111111
