111111111111
110000000001
100000110001
110010110141
110000200001
100013010101
100100010101
100110110001
100010100001
101000010011
100000010011
111111111111
