111111111111
110000000111
100301100101
100100400001
100111101001
100001101101
140001000001
100110123001
100000100001
101010100101
100000000001
111111111111
