111111111111
100000000001
100111000101
100002010101
101010110101
100010014101
101100000001
100001110001
101011000301
100000000001
100001111111
111111111111
