111111111111
111111111011
110000010011
100310000001
100001400001
110001401011
100111111311
110111110001
100000020001
100000000001
100111100101
111111111111
