111111111111
104000000001
110000000001
100100300001
101000000001
101003000001
100003002001
100010044001
100000000001
101000000001
100000000001
111111111111
