111111111111
100000001001
100100000001
100010000001
100310400101
100000000001
110003000001
100004100001
100000200001
100000000001
100000000001
111111111111
