111111111111
100000000001
100000000001
100020003001
104140100001
100000000001
100003430001
100000000101
100000000001
103400000001
100000000001
111111111111
