111111111111
100000000001
100300000001
110400000001
100300000041
100004031001
100000020001
100000010001
100000000001
101000000011
103004000001
111111111111
