111111111111
101000040001
100000000001
100030000001
100000300401
140003300001
110002000001
100100000011
101000000001
140000000001
100000000001
111111111111
