111111111111
100000000001
100000100201
140000001001
110000100001
100000300001
100400100011
100100300001
110010000001
110000000001
100000000001
111111111111
