111111111111
100000000001
100000000001
100043100001
100103000001
100010000001
100003200001
100001400001
100000000001
100000004001
100000000001
111111111111
