111111111111
100000000001
101003000001
100110000001
100003000001
100000400001
100000000001
100042000001
100000030001
100010000001
140000000001
111111111111
