111111111111
100100000001
100000002001
104110001001
100103000001
100003004101
100030000001
100000000001
100000000101
100040100001
100000000001
111111111111
