111111111111
100000010001
100000000001
110000002001
100100410101
100030000001
100000431001
100000000001
100000413001
100000000001
110000000001
111111111111
