111111111111
100010000001
100000000001
110300000301
100000004001
100032300001
140000400001
100001100001
100000011001
100000000401
100000000001
111111111111
