111111111111
104040001001
100100000401
100000000001
100013030001
100100000001
110000203001
100000000101
100110004001
103100000001
100000000001
111111111111
