111111111111
100100100001
100000010001
100001040011
100001300001
100003200001
100000340001
100001000001
110004000001
100000000001
101000000001
111111111111
