111111111111
100000000001
101000000011
100010030001
100000030011
100000000001
110040432001
100000000001
100100000001
110000000001
100000110401
111111111111
