111111111111
100000000001
100033001001
100003000001
110000400001
104000000001
100003000001
100000002001
140001030001
100000001041
100000000041
111111111111
