111111111111
100000000001
100030010001
100000000401
100400100001
100000100001
100003401201
110003100101
100000000001
100000000001
101000100001
111111111111
