111111111111
100000000001
100000000001
140000000401
100000000001
100003002001
100003000001
101000000001
140000300001
101110000001
100000034001
111111111111
