111111111111
100001000011
100000003001
100000000001
101030030001
100000000001
100040000141
100000002101
101010000001
100000000001
100000100041
111111111111
