111111111111
100000000001
120000101001
114010000401
100010000001
100000001011
100100300001
100100000001
100000130011
100100000001
100000000001
111111111111
