111111111111
100000000011
101000000001
100003001001
100300000101
100000044001
100000000011
110000000001
100000002001
103000000001
104000000001
111111111111
