111111111111
100000000001
100104000001
100000000401
100130013001
100020300001
100000000001
100100010001
100000000401
110000000001
100000000001
111111111111
