111111111111
140000000001
100000000011
101000301001
100003000001
101000300001
100003004001
140000000001
110000240001
100000100001
100100000001
111111111111
