111111111111
100400000001
100000031001
103001300001
100010000001
100002001001
110004000001
110000400001
110000000001
100000000001
100000000001
111111111111
