111111111111
100000000001
100000000001
103000000001
100004400001
100100400001
100000300001
100001300001
110000211001
100001010001
110000001001
111111111111
