111111111111
100100000001
104000000001
130001130001
100040000001
100000000001
140000000001
101030200001
101000000101
100000001001
100000000001
111111111111
