111111111111
101001000001
100000000001
104000000011
100000000001
100110300011
100003004001
100002100011
100000000001
100001101011
100101000001
111111111111
