111111111111
100000000101
100000000001
101100000001
100300410001
100003000011
100003001001
100010200001
100000000011
100041000041
100000000001
111111111111
