111111111111
104000000001
101403103001
100000014001
100300300001
100000003001
100000200001
100000000001
100040000001
100000000001
100000000041
111111111111
