111111111111
100000004401
100000000101
100100000001
100000000001
103000000101
100000043001
100000030001
100010402001
100003000001
100000100001
111111111111
