111111111111
100000000001
104003000001
100000000201
100001000001
110000340041
100000300031
100000000001
100003000001
100000010001
100041000141
111111111111
