111111111111
100010000001
100100000001
110000310001
100000410001
100300203001
100040400001
100000100001
100100000001
100000000001
100100010001
111111111111
