111111111111
100000000001
103000000001
100000000001
100000000341
100000401001
100100000001
100000410001
100001001001
100300002001
101000000001
111111111111
