111111111111
100000100001
110000010001
100400030001
100000030101
100004000001
100030120041
100000010001
100001000001
100000101001
100000001001
111111111111
