111111111111
100000000001
100001000001
100300040001
100010300041
100000310001
100000020001
110000430001
100000004001
101000000001
100000000001
111111111111
