111111111111
100000010001
100100010001
100010100001
100000430001
100000000001
110000103001
100001402001
100000000001
100010100001
100000100001
111111111111
