111111111111
100400000001
100000000001
100000000001
100000000001
100002040001
100300000101
110010014301
140010003001
100000030001
100101000001
111111111111
