111111111111
100000000011
100000000001
100004000001
101000300001
100040030001
100000200001
101041100001
100001000001
100000000301
100001010001
111111111111
