111111111111
100000000001
100010000001
101110030041
100000000101
110000000001
100000030001
100000030001
104020000001
100100100001
101000000041
111111111111
