111111111111
100000000001
100000100001
100000330001
100010000001
100010300001
110104400001
100004200001
101001100001
100000000001
100000000001
111111111111
