111111111111
110000000001
100100000001
100030000001
100000440001
100032000001
100030000001
100101000001
100000000001
110000000011
104000000001
111111111111
