111111111111
100040040001
101000000001
100000000001
100000000001
100003030001
103000400001
100000200001
100000103001
100000000001
100000004001
111111111111
