111111111111
103040010001
101003000001
100400000001
100000020401
100000000101
100000300001
100000000401
100003000001
100000000001
100101000001
111111111111
