111111111111
100000000011
100100111011
100000000001
100000330101
101000004001
100000420101
101000000001
100000000001
111000000001
100000000001
111111111111
