111111111111
100000044011
100000000001
100300000001
100000400001
100003000001
100000310001
100000023001
100101000001
100000000001
140000000001
111111111111
