111111111111
100000000001
140001000001
100000010001
110000000001
100130301001
100030000001
100000420001
100010001001
100000000001
100000004001
111111111111
