111111111111
104000001001
140010001001
100000000401
100100000241
100000010001
100003300001
100000000001
100000330101
100000000001
101001000001
111111111111
