111111111111
100000000001
100000000001
101000000001
100003000001
100000400001
100003200001
100403000001
100000410001
100000010001
101000000101
111111111111
