111111111111
100000304001
100000000001
100300040001
100000103001
100100040001
100100000011
104000200001
103000400001
100003000001
100000000001
111111111111
