111111111111
111010011011
100303011011
110100010011
110000000111
114111110111
110011100101
110000010001
140113110001
100400010011
100000000021
111111111111
