111111111111
101100001111
100000011101
100001010001
111001000001
112011104101
111011103001
100011001011
110000000011
110011001011
100000000011
111111111111
