111111111111
110000000001
100000401001
100000000001
100000000101
100000003001
100304010001
100000300001
100101241001
100000000111
110000000001
111111111111
