111111111111
100000000001
100000000001
100101003001
100400000001
100110040001
100003004001
100300240001
100011310001
100000000001
100000000001
111111111111
