111111111111
100010000001
103000000001
100000000001
110010000001
100001040001
100000103001
103000000101
140000041001
100000000001
102000010001
111111111111
