111111111111
100000000001
110000100001
100000100001
100103000011
100010001001
101040041001
100010330001
100000200101
100000004001
100000000001
111111111111
