111111111111
110010010001
100000000001
100000000001
100030000001
100000030001
100030042001
100001004001
100000410001
100000010001
100000000001
111111111111
