111111111111
100100000001
100000000001
100000101011
101030000001
100000000001
101004341001
100001002001
100000011011
100000000001
100000000001
111111111111
