111111111111
100000000001
100000100001
100000300101
100100010001
100100000001
100003404001
100000102001
100011100001
100000000001
100000000101
111111111111
