111111111111
100000000001
100000300011
100000000001
100000000001
100000100001
101000441001
100000020001
100011300101
100010001001
110000100001
111111111111
