111111111111
100000000001
100100000001
100300001001
100000410011
100000100001
100010000001
100001000001
101001213101
100000400001
100100000011
111111111111
