111111111111
100010000001
100000000001
100100000001
100100000001
100030040001
100030331101
100010001201
100000440001
100000140001
100000000001
111111111111
