111111111111
100000000001
100000000001
100000030001
100000300101
100000430001
100100040001
100004300041
100110210001
100000010001
100000000001
111111111111
