111111111111
100100000001
100000000001
100011100001
100000000001
100000000401
100003011001
101013100001
100000204001
100000000001
100000000001
111111111111
