111111111111
100001100001
100300000001
100001000011
110000030001
101000000001
100000114001
104000000001
100000000001
100000000001
100200000001
111111111111
