111111111111
100000000001
100110000001
100010000001
100010111001
100000000001
101000440001
100030341011
100000230011
100000100001
100000000001
111111111111
