111111111111
100001000001
110130001011
100000100001
100010000401
100100102001
100000000001
110000300001
100011000001
100400000001
100100001001
111111111111
