111111111111
100000000001
101000000001
100000040001
100003000101
100001000101
101103002001
100100000001
100011400001
100000000001
100100000001
111111111111
