111111111111
100000000001
100000000001
101000300001
100300400001
100400000001
100000000001
100010402001
100013100101
100010000001
100000000001
111111111111
