111111111111
100100010001
100000000001
100010000001
100000000001
110000003001
110000410001
100130043011
100000021011
100001104001
100000000001
111111111111
