111111111111
100000000001
101000000011
100010010001
100000003101
100000000001
100004010101
100010340001
100000000001
100000200001
101000011001
111111111111
