111111111111
100000000001
100000000001
100001300001
100000000001
100410030001
100000304111
100000112041
100000000001
100000000001
101001000001
111111111111
