111111111111
100000000001
100001400001
100100000101
100000000001
100000300001
100003301001
100041023011
100000000401
100100000401
100001000001
111111111111
