111111111111
100000100001
100000300101
110000000001
100001000001
100000401001
100403000001
100003200001
100000010001
100000000001
100000004001
111111111111
