111111111111
101100001001
100004003001
101003000011
100040000001
101040040001
100301002001
100000001001
100000030001
100001000001
111010010001
111111111111
