111111111111
100000000001
100001001001
100000000001
100010000001
100010100001
100043431101
100000001001
101000000201
100000000001
100000000001
111111111111
