111111111111
100000000001
101100000001
100000130001
100010000001
100000000001
100000404001
100003000211
100000000001
100011000001
100000000001
111111111111
