111111111111
100000000001
110000000001
100003100001
100010011111
100000400001
100003042001
100011000001
100001101001
100000100101
100000000001
111111111111
