111111111111
100000000001
100000000001
100104440001
100000000001
100000330001
100003300201
100110030001
100000011001
100000400401
100100000001
111111111111
