111111111111
100100000001
100100001001
100000300001
100010400001
100000300001
100100400101
100003420101
100110000001
100000000001
100000000001
111111111111
