111111111111
100000000001
100000000001
100100004001
100300001001
100011000001
101300004301
101004010001
100000100001
100000021001
110000000011
111111111111
