111111111111
140000000001
100014000001
144000000011
130000000001
103000010001
100003000301
103002010101
100001000001
100000000401
100100001001
111111111111
