111111111111
100000000001
100000010011
100000000001
103000100101
100001040001
100000003001
100010430001
100010000001
100000200001
100404003001
111111111111
