111111111111
100000000001
110000100001
100100000001
100000000001
100000130001
100010342001
100000400001
101001000011
100000000001
100000000101
111111111111
