111111111111
100000000001
100010000001
100000100001
101310000101
100001340001
100000301001
100040401001
100001110201
100000000101
100000000001
111111111111
