111111111111
100000000001
100131000001
100040300101
100000040001
100001040001
100000001001
100030110021
100010000001
111030001001
104000000001
111111111111
