111111111111
100000000001
100001400101
100000000001
100300000001
100000001101
110101100301
100000400001
100100211101
100000000001
100000000001
111111111111
