111111111111
100000000001
100010100001
101100001101
100010003001
100001000101
100000100101
100000410201
100300040001
100010010001
100000000001
111111111111
