111111111111
100000000001
100000000101
101003000001
100000000001
101000400101
100000003001
110300004201
100000140101
100000000001
100100000001
111111111111
