111111111111
100000000001
100110001011
100000100011
100031000001
100001000001
100010001001
100020000101
110000010001
110010000001
100410000001
111111111111
