111111111111
100000000001
100000010001
100101100101
100000000001
100103401001
100003000001
100010410001
100103412001
100001000001
100000000001
111111111111
