111111111111
100000000001
100000300001
100000000001
100101300101
110000041001
100000211001
100000140011
100100000001
100010100001
100000000001
111111111111
