111111111111
100034000001
100100000001
100000314001
100100001101
102010000401
100000000001
100400300101
100000000001
100003000011
100000100001
111111111111
