111111111111
100000000001
100000010001
100100010001
111000001001
100000033001
100100104001
100000000001
104000000001
100110000201
100000010001
111111111111
