111111111111
100000000001
100000000001
100100000001
100001301101
100140000001
100100030001
100004304201
100001001001
100000000001
100000000111
111111111111
