111111111111
100000000001
100000000101
100000311001
100000400001
100100000001
100000341001
100010201001
100000100101
100000001001
100000000001
111111111111
