111111111111
100000000001
100300000001
100000003001
100000101001
100000001001
100400440001
100300020001
100001000001
100000001001
100000000001
111111111111
