111111111111
110000000001
110000110001
100000100001
100010001011
100300030001
110000344001
100000402001
100000010301
100010040001
101000000001
111111111111
