111111111111
100000000001
100000010001
100000000001
100300000001
100000011001
100010200101
100003440001
100000000001
100000100011
100000000001
111111111111
