111111111111
100000000001
100000010001
100011330041
104000000001
100000000001
104100400001
101100030001
101003003211
110000100101
100100000401
111111111111
