111111111111
100000000001
110000130001
100100000001
100100000001
100000001001
110003104001
100103402011
100000400001
100000010001
100000000001
111111111111
