111111111111
100000000001
101000000001
100000001001
100013040101
100000010001
100001103101
100000240001
101000001001
100000110001
100000001001
111111111111
