111111111111
100000000001
101300000001
104000000001
100010000001
100000104001
100011040001
100000000011
100103032001
101000010001
100000000001
111111111111
