111111111111
100000000001
100000000001
110000030001
100000003001
110000000011
100400040101
100031420001
100000100101
100000000001
100000010001
111111111111
