111111111111
100000000001
100310010011
100000000001
100200000001
100003101011
100010001001
100010040001
100001104011
101000000001
100000100001
111111111111
