111111111111
100001000001
100000000001
100000000001
100000000001
100310301201
101001041001
100010440001
100000000101
100003000001
100000000001
111111111111
