111111111111
100000000001
101000000001
100000000001
101003003001
100000100001
100013200001
100400000001
100100414001
100001000001
100000000101
111111111111
