111111111111
100000000001
100110000001
100000000001
100100300001
100000031001
100000430001
100000204101
100000004001
100000000001
100001000001
111111111111
