111111111111
101000000101
100000000001
100000000001
100400000001
100000100001
100030100041
100000200011
103000300111
100100400001
100000010001
111111111111
