111111111111
110000000001
100000000001
100003000001
100010341001
100010000001
100001104011
100100002001
100000000001
100000000001
100000000001
111111111111
