111111111111
100000000001
110030011001
100113100011
100000010001
100140000001
100000441001
100300201011
100100100001
100000000001
100000000001
111111111111
