111111111111
101000000011
100003100001
100000100001
100000000001
101000010101
101000010001
100100310041
100001020001
100000040001
100000001001
111111111111
