111111111111
100000000001
100000000001
100000001001
100001000001
100010401001
100013100001
100003000101
101000102001
100010400001
101000100001
111111111111
