111111111111
100000000011
100000000001
100000010001
100000011101
100001003001
100011420001
110000300001
100011010101
100000004101
100100000001
111111111111
