111111111111
100100000001
100030000001
100000001001
100001000101
100100040001
101000442001
100001130001
100030000101
100010001001
100000000001
111111111111
