111111111111
100000000001
100010400001
100003000001
100000000001
100000300101
100003000001
100000104101
100000240001
100000000001
100000000001
111111111111
