111111111111
100000000001
100000100011
100000000001
100000000001
101000030011
100011340001
100010401001
100000200001
100000100001
100000010001
111111111111
