111111111111
100000000001
140000000001
110001000001
100003000401
100100300001
110000320101
110010140001
100000000001
100000000001
100010000001
111111111111
