111111111111
100000000001
100000001001
100000040001
101001000101
100000000001
100033302101
100100000001
104004000001
100000000001
100000000001
111111111111
