111111111111
100100000001
110100010011
100000010001
100000040001
100000130001
100001140001
100000010101
100300200001
101000000011
100000000001
111111111111
