111111111111
100001110101
101000000001
100010000001
101000000101
100000401001
100003004041
100010000001
100100302001
100000300001
100000100001
111111111111
