111111111111
100000000001
100000003001
100100000001
100010040001
100010000001
100000040001
100300120001
100000000001
100000000001
100000000101
111111111111
