111111111111
100000000001
100000100001
100000100401
100000000141
100003320001
100000031001
101000100001
101000000001
110000000401
100000000001
111111111111
