111111111111
100000000001
100041000001
100000101001
100000000001
111000403001
104101403011
100000120001
103300010001
100000000001
100000000001
111111111111
