111111111111
100000000001
100000010001
101113000001
100000040001
100000200001
110010100001
100000000401
100000110001
100000300001
100000000001
111111111111
