111111111111
100000000001
110001000001
100000000101
103000103001
100000012001
100100040001
100010000101
101004000001
100010000001
101000000101
111111111111
