111111111111
100000000001
100000000001
100000000001
100100004001
110010040001
100000301001
100000002001
100300000101
100000000001
100000000001
111111111111
