111111111111
100000000001
100101000001
100111000001
100000300001
100400001001
100003023001
100100000001
100040100001
100000000001
100001001401
111111111111
