111111111111
100000004001
100000000001
101000000001
101010000001
100000003001
100000402001
110000003001
110000000001
100030000001
100001000041
111111111111
