111111111111
100000101101
100000001101
100000000001
100000400001
100411003101
100011000001
100310000101
100302010001
110000010001
100000000411
111111111111
