111111111111
101000000001
104000000101
100100100001
110011000001
100000230011
100100310041
101100000001
101001000001
100000000001
100000000001
111111111111
