111111111111
100101100101
100100000001
101000000001
100000030001
100000300001
100014010011
100010000011
100042000011
100000001001
100000000001
111111111111
