111111111111
100000000001
101000000001
100000000001
100040004001
101301002011
100000000011
100000300001
100000000011
100000010001
100000000001
111111111111
