111111111111
110000000001
100003000001
100010000001
100000000001
101000120001
100000040001
101000000001
100000300001
100040000001
100000000001
111111111111
