111111111111
100100000001
100003000001
101000000001
100000000001
100010000001
100000404011
100030000001
110000200001
100000000001
100000000001
111111111111
