111111111111
100010011001
101000000001
101000000101
100011001101
100000000001
100011203101
100000400111
100101400001
100001010301
100001000001
111111111111
