111111111111
100000000001
100000000001
101000001001
100001004011
100101000011
100300030101
100000200001
104010000101
100100010001
100001000011
111111111111
