111111111111
100010000001
100000000001
100000000001
100030114001
100000004011
100000042001
100000300101
100003000001
100000000001
100000000001
111111111111
