111111111111
100010000001
100010000101
100000001001
100000031001
100001301001
100012011001
110000100001
100004000001
101410000001
100010010001
111111111111
