111111111111
100101010001
100000000001
100000300001
100100044001
100000000001
100003030001
100100000001
100000000001
100002000011
100000400001
111111111111
