111111111111
100100000101
100000000001
100000300011
100000030041
100000020001
100101034001
110000000001
100004010001
100010000101
101000000001
111111111111
