111111111111
100000000001
100000001001
100001000001
100031004001
100030002101
100000340001
100104001001
100000000001
100000001001
100000000001
111111111111
