111111111111
100100001001
100000000101
100001000001
100000400001
100000200101
100000000011
110000000001
100300100001
100000001301
100000040001
111111111111
