111111111111
100004340001
100000000011
101003000011
100010000001
100000000001
100000200001
100301100001
100000010101
100000010101
100000004001
111111111111
