111111111111
100000000101
100000000001
101010100001
100000001001
100010402001
100100003001
110110000101
100100100001
103000000001
100000140001
111111111111
