111111111111
100010000001
100000000001
100004001001
100000003001
100000000001
100000000001
100140010011
100020100001
101300000001
100000000001
111111111111
