111111111111
100100001101
100000000001
100003000001
111000000001
100000100001
100400034001
110000400001
100030000001
100000020001
100000000001
111111111111
