111111111111
100001000011
100010001001
101000100001
100001001001
100140300001
100000104001
103010000011
100102000011
100000000001
100000000001
111111111111
