111111111111
100000000101
100000000001
100000000001
110000400001
100010303011
100003000001
100040200001
101010000001
100000000011
100000040001
111111111111
