111111111111
104000000001
101000010001
100000010001
101010000001
103000100001
113010002001
100001040001
100000110001
100000100001
100000000001
111111111111
