111111111111
100010000001
100000000001
101003000001
100000003001
100400010101
100004020001
100000000001
101000000001
100000100001
110000010001
111111111111
