111111111111
141000000101
100000000001
100010000001
100100001101
100040002001
100300033011
103040100001
100000101011
100000000001
100000000401
111111111111
