111111111111
100000000001
100101000001
100010000011
100000003101
101010032001
100400000401
100000130001
100100000001
100000001111
100000000401
111111111111
