111111111111
100000000001
100000000001
100000300001
100100401001
100000000001
111300120001
100000110101
100001000001
100001000401
100000001001
111111111111
