111111111111
100100000101
100000010001
100000011011
100000040001
100000000001
100000040001
103120003001
100000000001
100101000001
100000000001
111111111111
