111111111111
100001000011
100000000001
100000100001
100000030001
100000030001
100000100001
104100200001
100100000001
100001000001
100000040001
111111111111
