111111111111
100000001001
100000000001
100010030001
111000000001
100004032001
100000004001
100000100001
103400000001
100000000001
100000000101
111111111111
