111111111111
114000000001
100001000011
110100100101
101040001001
100003000401
101011000001
103001030001
100020000001
101100000001
100000000001
111111111111
