111111111111
100010000101
100001000001
100100000001
100000040001
110101300001
100000000011
100300002001
100010000001
100000000001
100000400001
111111111111
