111111111111
100000401141
110000000001
100000001001
101000011001
100000230041
110030100001
100100000101
100000000001
100010300001
100100000011
111111111111
