111111111111
100110010001
100000010001
100111040001
100000200101
100000000001
100000330111
100000010001
100400000001
100001000001
100000000001
111111111111
