111111111111
100000000001
100000000001
100000000001
111000000001
100030302001
100400004001
100000314001
100000000001
100000000001
100000000001
111111111111
