111111111111
100000010001
100000000001
100030000101
100030004011
100000014001
100400000001
101102000001
100000000111
100000003001
100000000001
111111111111
