111111111111
100000000001
100000001101
110200004001
100100000101
101000000001
100000000101
101100001001
100030300001
101000400101
100100000001
111111111111
