111111111111
100000000101
101010000001
100000101001
100310040001
100300012001
110000010001
100000040001
100030040001
100000010001
100000000001
111111111111
