111111111111
100000000001
100000000011
100000000001
100001040001
100000023001
100301004001
100301000001
100000040001
100000010001
100000000001
111111111111
