111111111111
100100000001
100100001001
100000030001
100000010001
100000001001
100100020111
100014000001
101100340001
100001000001
100000000001
111111111111
