111111111111
100000000001
100000000001
100000000011
100000001001
100400033001
100000000011
100010010001
100001420001
100000000001
101000000001
111111111111
