111111111111
100000000001
100110011001
110000000001
101000303011
100001010001
101002010101
110000400101
100400000001
100001000001
100000010001
111111111111
