111111111111
100000000001
100000000001
100100000001
100110000001
100040003001
110000144001
100002300001
100300000001
100000000001
100000000001
111111111111
