111111111111
100000000001
100000000001
100040013011
100000000001
100000000001
102010100141
100000000401
100000000001
100033001001
100100000101
111111111111
