111111111111
100000000001
100010000001
100000000001
100000000001
103000010101
100000023001
100100000011
101400000001
100010000001
141000001001
111111111111
