111111111111
100010000001
100000300001
100000000001
100000014001
100004040001
100100130001
100002300001
100000000001
100000000001
100000000001
111111111111
