111111111111
100000000001
104400000001
100110000001
113000040001
100000001001
101030304011
104100300001
100000230001
100000000001
100101000001
111111111111
