111111111111
110000000001
100001100001
100110030101
100010040001
100010020001
100000040001
100000011011
100000000001
110300010001
100000000001
111111111111
