111111111111
100000001001
100030000001
100000000001
100000004001
100000030001
100010404001
100000200111
100030000001
100000000001
100000000001
111111111111
