111111111111
100000000001
100000000001
110100101001
100000103001
100011034001
100001000001
100031002001
110000000001
104000000001
100401100001
111111111111
