111111111111
100000000001
100101040001
103000000001
100410103001
100000003001
100010002001
100000400001
100001000101
110000000001
100100101001
111111111111
