111111111111
101000100011
100000100001
100001001011
101000300001
100010100001
100000424001
110010300001
100000001001
100100000101
100010000001
111111111111
