111111111111
100000101001
100000000001
100000000001
110000410011
100010040001
100000300001
100000120101
101000100001
101030000011
100000000001
111111111111
