111111111111
100000000011
101000001011
100000400001
100010001001
110100030011
100003000011
100001030041
100020010001
100040000001
100000000001
111111111111
