111111111111
100000001001
100000100001
100000000001
100000030001
101000011101
100000003001
100000004141
110000000001
110100200001
100100000101
111111111111
