111111111111
100001000001
100000001001
100101000101
100100010001
100000043001
100002040001
100304000001
100300000001
100000000001
100000000001
111111111111
