111111111111
100400000001
100000000101
111001000001
100000030001
100100320001
100103000001
100000000001
100000000001
110040000041
100000000001
111111111111
