111111111111
101100000001
100000100001
100000101001
100000002101
113001300001
100000001001
100001100011
100000400001
100000400001
100000000011
111111111111
