111111111111
100000000101
100000000001
103000000001
100100010011
110000140101
100003200101
100000303401
100000000111
100040000001
100100040001
111111111111
