111111111111
110010001001
110001000001
100031300001
100000000101
100000000001
100000004401
100000200001
101000000101
100000110001
100000000001
111111111111
