111111111111
100000000101
100000001001
101001000001
101000131011
100000030001
100000002001
110000300001
100041100441
101001010001
110000011101
111111111111
