111111111111
101000000001
100000000001
100000000001
101000030001
100000012001
101000104001
100000040001
100013001001
100000000011
100000000011
111111111111
