111111111111
100000010001
100000000001
100000100001
100300000001
100000000301
100000124001
100014004001
100030000001
100000000011
110000000001
111111111111
