111111111111
100000000041
100000000001
100011000001
100001330001
100000020001
100400300001
100000000011
100004010001
100000000001
100000000101
111111111111
