111111111111
100001011111
101100001111
101101010011
101103000001
101000010101
101100010001
100101100101
110000011111
110040200001
100111100011
111111111111
