111111111111
100000000111
100110000001
100010141001
110110100001
100032041001
100011341001
100100300001
103000001101
101101100001
100000400011
111111111111
